player,nationality,position,team,age,birth_year,minutes_90s,tackles,tackles_won,tackles_def_3rd,tackles_mid_3rd,tackles_att_3rd,challenge_tackles,challenges,challenge_tackles_pct,challenges_lost,blocks,blocked_shots,blocked_passes,interceptions,tackles_interceptions,clearances,errors,matches
David Abraham,ar ARG,DF,Eint Frankfurt,31,1986,25.6,40,32,29,10,1,27,36,75.0,9,29,15,14,40,80,141,1,Matches
Amir Abrashi,al ALB,MF,Freiburg,27,1990,9.4,35,32,15,18,2,16,23,69.6,7,22,5,17,19,54,20,0,Matches
René Adler,de GER,GK,Mainz 05,32,1985,14.0,1,1,1,0,0,1,1,100.0,0,0,0,0,0,1,8,1,Matches
Ailton,br BRA,"DF,MF",Stuttgart,22,1995,1.2,8,5,3,5,0,4,8,50.0,4,5,0,5,2,10,5,0,Matches
Manuel Akanji,ch SUI,DF,Dortmund,22,1995,10.0,22,15,14,8,0,15,17,88.2,2,11,4,7,7,29,43,2,Matches
Chadrac Akolo,cd COD,"MF,FW",Stuttgart,22,1995,12.2,20,14,3,12,5,6,14,42.9,8,19,0,19,5,25,5,0,Matches
Kevin Akpoguma,ng NGA,DF,Hoffenheim,22,1995,18.8,47,39,29,16,2,24,35,68.6,11,18,4,14,22,69,60,1,Matches
David Alaba,at AUT,DF,Bayern Munich,25,1992,17.2,23,14,11,9,3,14,20,70.0,6,21,6,15,10,33,23,0,Matches
Lucas Alario,ar ARG,FW,Leverkusen,24,1992,17.2,16,10,2,12,2,3,8,37.5,5,17,4,13,4,20,16,0,Matches
Miiko Albornoz,cl CHI,"DF,MF",Hannover 96,26,1990,7.8,24,20,17,4,3,11,16,68.8,5,15,2,13,5,29,23,0,Matches
Thiago Alcántara,es ESP,"MF,FW",Bayern Munich,26,1991,13.9,45,35,11,25,9,15,26,57.7,11,22,3,19,27,72,6,1,Matches
Stephan Ambrosius,gh GHA,DF,Hamburger SV,18,1998,0.5,0,0,0,0,0,0,0,,0,2,1,1,1,1,4,0,Matches
Nadiem Amiri,de GER,MF,Hoffenheim,20,1996,19.4,39,26,13,21,5,19,42,45.2,23,33,4,29,17,56,7,0,Matches
Waldemar Anton,de GER,"DF,MF",Hannover 96,21,1996,25.3,65,49,39,21,5,41,65,63.1,24,56,27,29,39,104,112,3,Matches
Dennis Aogo,de GER,"MF,DF",Stuttgart,30,1987,21.7,35,26,17,18,0,14,22,63.6,8,27,3,24,29,64,27,1,Matches
Charles Aránguiz,cl CHI,MF,Leverkusen,28,1989,25.6,75,61,17,50,8,33,62,53.2,29,46,5,41,48,123,27,2,Matches
Maximilian Arnold,de GER,MF,Wolfsburg,23,1994,27.3,51,41,23,23,5,25,57,43.9,32,31,4,27,28,79,34,0,Matches
Jann-Fiete Arp,de GER,"FW,MF",Hamburger SV,17,2000,9.4,7,5,0,3,4,1,7,14.3,6,6,0,6,2,9,7,0,Matches
Takuma Asano,jp JPN,"FW,MF",Stuttgart,22,1994,8.0,7,5,3,3,1,2,8,25.0,6,7,0,7,3,10,2,0,Matches
Santiago Ascacíbar,ar ARG,MF,Stuttgart,20,1997,26.5,91,65,41,43,7,41,74,55.4,33,45,10,35,47,138,38,1,Matches
Simon Asta,de GER,MF,Augsburg,16,2001,0.1,2,1,2,0,0,2,2,100.0,0,1,0,1,0,2,0,0,Matches
Pierre-Emerick Aubameyang,ga GAB,FW,Dortmund,28,1989,15.7,5,5,1,1,3,2,8,25.0,6,16,1,15,3,8,1,0,Matches
Jean-Kévin Augustin,fr FRA,FW,RB Leipzig,20,1997,14.1,16,11,4,11,1,3,7,42.9,4,17,1,16,4,20,4,0,Matches
Ludwig Augustinsson,se SWE,"DF,FW",Werder Bremen,23,1994,28.1,45,34,22,20,3,22,32,68.8,10,25,3,22,39,84,53,0,Matches
Yann Aurel Bisseck,de GER,"DF,MF",Köln,16,2000,1.7,2,2,2,0,0,1,1,100.0,0,1,1,0,3,5,8,0,Matches
Holger Badstuber,de GER,"DF,MF",Stuttgart,28,1989,24.1,44,32,29,14,1,22,39,56.4,17,27,14,13,41,85,111,4,Matches
Daniel Baier,de GER,MF,Augsburg,33,1984,28.2,83,62,38,40,5,46,83,55.4,37,26,5,21,57,140,41,1,Matches
Leon Bailey,jm JAM,"FW,DF",Leverkusen,19,1997,24.6,16,12,7,4,5,8,13,61.5,5,28,0,28,15,31,6,0,Matches
Marvin Bakalorz,de GER,MF,Hannover 96,27,1989,22.8,44,25,19,23,2,22,37,59.5,15,38,7,31,20,64,46,1,Matches
Ridle Baku,de GER,MF,Mainz 05,19,1998,2.6,3,3,1,1,1,0,1,0.0,1,3,0,3,3,6,2,0,Matches
Leon Balogun,ng NGA,DF,Mainz 05,29,1988,13.0,39,32,27,11,1,22,31,71.0,9,21,9,12,32,71,64,0,Matches
Philipp Bargfrede,de GER,MF,Werder Bremen,28,1989,20.7,60,45,29,30,1,33,55,60.0,22,35,12,23,47,107,52,0,Matches
Aymen Barkok,ma MAR,"FW,MF",Eint Frankfurt,19,1998,3.5,11,11,6,4,1,5,7,71.4,2,8,2,6,2,13,3,0,Matches
Fin Bartels,de GER,FW,Werder Bremen,30,1987,12.5,12,9,4,3,5,4,12,33.3,8,5,1,4,7,19,1,1,Matches
Marc Bartra,es ESP,DF,Dortmund,26,1991,9.0,28,19,16,12,0,15,24,62.5,9,14,2,12,28,56,43,1,Matches
Michy Batshuayi,be BEL,FW,Dortmund,23,1993,9.3,8,6,1,4,3,2,4,50.0,2,4,0,4,0,8,5,0,Matches
Robert Bauer,de GER,"DF,FW",Werder Bremen,22,1995,10.6,31,25,21,9,1,15,25,60.0,10,8,2,6,21,52,25,2,Matches
Oliver Baumann,de GER,GK,Hoffenheim,27,1990,34.0,0,0,0,0,0,0,2,0.0,2,0,0,0,1,1,15,6,Matches
Timo Baumgartl,de GER,DF,Stuttgart,21,1996,29.0,87,71,55,29,3,56,75,74.7,19,50,21,29,34,121,132,1,Matches
Julian Baumgartlinger,at AUT,"MF,DF",Leverkusen,29,1988,15.5,47,37,21,21,5,14,29,48.3,15,25,2,23,18,65,23,0,Matches
Noah Joel Sarenren Bazee,ng NGA,"FW,MF",Hannover 96,20,1996,1.3,0,0,0,0,0,0,0,,0,3,0,3,0,0,3,0,Matches
Riechedly Bazoer,nl NED,MF,Wolfsburg,20,1996,6.6,8,7,5,2,1,2,4,50.0,2,2,1,1,8,16,4,1,Matches
Ihlas Bebou,tg TOG,"MF,FW",Hannover 96,23,1994,23.8,37,29,15,17,5,14,27,51.9,13,34,3,31,24,61,27,0,Matches
Andreas Beck,de GER,DF,Stuttgart,30,1987,21.4,46,29,27,16,3,21,31,67.7,10,32,2,30,19,65,46,1,Matches
Ishak Belfodil,dz ALG,FW,Werder Bremen,25,1992,15.0,7,6,2,3,2,0,3,0.0,3,10,1,9,1,8,9,0,Matches
Stefan Bell,de GER,DF,Mainz 05,25,1991,24.2,36,25,23,13,0,27,39,69.2,12,35,18,17,46,82,123,2,Matches
Karim Bellarabi,de GER,"MF,FW",Leverkusen,27,1990,12.7,22,17,10,9,3,10,19,52.6,9,26,1,25,13,35,5,0,Matches
Lars Bender,de GER,"DF,MF",Leverkusen,28,1989,17.7,63,52,26,32,5,35,53,66.0,18,34,7,27,28,91,40,0,Matches
Sven Bender,de GER,DF,Leverkusen,28,1989,26.1,51,37,33,18,0,26,34,76.5,8,49,21,28,50,101,123,1,Matches
László Bénes,sk SVK,MF,M'Gladbach,19,1997,0.4,0,0,0,0,0,0,1,0.0,1,2,1,1,1,1,2,0,Matches
Marcel Benger,de GER,MF,M'Gladbach,19,1998,0.0,0,0,0,0,0,0,0,,0,0,0,0,0,0,0,0,Matches
Charlison Benschop,cw CUW,"MF,DF",Hannover 96,27,1989,2.0,4,4,1,3,0,3,8,37.5,5,1,0,1,2,6,2,0,Matches
Nabil Bentaleb,dz ALG,MF,Schalke 04,22,1994,11.2,25,22,7,17,1,8,23,34.8,15,18,6,12,23,48,27,2,Matches
Emil Berggreen,dk DEN,FW,Mainz 05,24,1993,7.4,2,2,0,0,2,1,4,25.0,3,7,1,6,1,3,10,0,Matches
Bernardo,br BRA,DF,RB Leipzig,22,1995,15.0,43,30,18,22,3,29,40,72.5,11,30,6,24,18,61,81,0,Matches
Juan Bernat,es ESP,"DF,FW",Bayern Munich,24,1993,9.9,25,19,13,8,4,11,18,61.1,7,11,1,10,10,35,9,1,Matches
Ermin Bičakčić,ba BIH,DF,Hoffenheim,27,1990,6.1,17,15,8,8,1,8,12,66.7,4,4,2,2,9,26,26,0,Matches
Leonardo Bittencourt,de GER,"MF,FW",Köln,23,1993,17.9,49,42,17,21,11,19,43,44.2,24,26,0,26,17,66,11,1,Matches
Pablo de Blasis,ar ARG,"FW,MF",Mainz 05,29,1988,18.4,39,23,19,11,9,16,33,48.5,17,33,0,33,10,49,34,0,Matches
Danny Blum,de GER,"MF,DF",Eint Frankfurt,26,1991,0.3,0,0,0,0,0,0,0,,0,0,0,0,1,1,0,0,Matches
Jérôme Boateng,de GER,DF,Bayern Munich,28,1988,18.2,26,18,18,7,1,19,32,59.4,13,20,12,8,21,47,52,1,Matches
Kevin-Prince Boateng,gh GHA,"MF,FW",Eint Frankfurt,30,1987,26.2,34,22,10,22,2,11,36,30.6,25,29,6,23,23,57,43,1,Matches
Raúl Bobadilla,py PAR,"FW,MF",M'Gladbach,30,1987,5.0,7,6,1,3,3,4,8,50.0,4,6,0,6,0,7,1,0,Matches
Julian Brandt,de GER,"FW,MF",Leverkusen,21,1996,25.8,24,18,11,9,4,11,29,37.9,18,23,1,22,16,40,12,1,Matches
Josip Brekalo,hr CRO,FW,Wolfsburg,19,1998,9.7,15,12,6,7,2,6,12,50.0,6,17,0,17,4,19,3,0,Matches
Josip Brekalo,hr CRO,"MF,FW",Stuttgart,19,1998,8.1,20,12,7,8,5,6,8,75.0,2,8,2,6,3,23,1,0,Matches
John Brooks,us USA,DF,Wolfsburg,24,1993,8.1,20,13,15,4,1,16,22,72.7,6,11,5,6,10,30,46,0,Matches
Daniel Brosinski,de GER,"DF,FW",Mainz 05,29,1988,27.8,45,35,21,18,6,22,44,50.0,22,46,11,35,24,69,75,2,Matches
Bruma,pt POR,"MF,FW",RB Leipzig,22,1994,17.9,18,16,7,7,4,9,18,50.0,9,28,2,26,12,30,11,0,Matches
Jeffrey Bruma,nl NED,DF,Wolfsburg,25,1991,11.0,13,11,13,0,0,6,14,42.9,8,17,12,5,14,27,43,2,Matches
Jacob Bruun Larsen,dk DEN,"MF,DF",Stuttgart,18,1998,1.2,0,0,0,0,0,0,0,,0,1,0,1,1,1,2,0,Matches
Jacob Bruun Larsen,dk DEN,DF,Dortmund,18,1998,0.1,1,1,1,0,0,1,2,50.0,1,0,0,0,0,1,0,0,Matches
Onur Bulut,tr TUR,FW,Freiburg,23,1994,0.4,0,0,0,0,0,0,1,0.0,1,0,0,0,0,0,0,0,Matches
Guido Burgstaller,at AUT,FW,Schalke 04,28,1989,25.8,14,9,0,10,4,4,14,28.6,10,28,3,25,10,24,9,0,Matches
Roman Bürki,ch SUI,GK,Dortmund,26,1990,33.0,1,1,1,0,0,1,3,33.3,2,1,0,1,0,1,10,4,Matches
Dženis Burnić,de GER,MF,Stuttgart,19,1998,3.4,9,6,2,5,2,4,10,40.0,6,2,0,2,4,13,3,0,Matches
Jakub Błaszczykowski,pl POL,"FW,MF",Wolfsburg,31,1985,5.8,12,8,8,2,2,6,13,46.2,7,11,3,8,5,17,3,0,Matches
Caiuby,br BRA,FW,Augsburg,29,1988,31.7,53,40,20,27,6,17,42,40.5,25,36,1,35,15,68,42,2,Matches
Luca Caldirola,it ITA,DF,Werder Bremen,26,1991,1.0,1,0,0,1,0,1,1,100.0,0,1,0,1,3,4,3,0,Matches
Daniel Caligiuri,it ITA,"DF,MF",Schalke 04,29,1988,32.4,100,66,48,43,9,49,94,52.1,45,59,4,55,67,167,71,0,Matches
Ignacio Camacho,es ESP,"MF,DF",Wolfsburg,27,1990,10.6,27,21,10,16,1,9,23,39.1,14,14,5,9,41,68,43,0,Matches
Koen Casteels,be BEL,GK,Wolfsburg,25,1992,34.0,2,1,2,0,0,2,2,100.0,0,0,0,0,1,3,16,1,Matches
Gonzalo Castro,de GER,MF,Dortmund,30,1987,13.4,26,18,7,18,1,5,22,22.7,17,23,3,20,10,36,13,1,Matches
Marijan Ćavar,ba BIH,MF,Eint Frankfurt,19,1998,0.4,0,0,0,0,0,0,3,0.0,3,0,0,0,0,0,0,0,Matches
Timothy Chandler,us USA,"DF,FW",Eint Frankfurt,27,1990,21.0,27,21,11,13,3,11,17,64.7,6,15,0,15,33,60,52,0,Matches
Per Ciljan Skjelbred,no NOR,MF,Hertha BSC,30,1987,24.3,89,66,33,54,2,42,64,65.6,22,31,6,25,45,134,23,0,Matches
Christian Clemens,de GER,"MF,FW",Köln,25,1991,7.2,12,11,6,5,1,4,13,30.8,9,8,0,8,4,16,7,0,Matches
Coke,es ESP,MF,Schalke 04,30,1987,0.0,0,0,0,0,0,0,0,,0,0,0,0,0,0,0,0,Matches
Kingsley Coman,fr FRA,"FW,MF",Bayern Munich,21,1996,12.8,11,10,2,6,3,5,10,50.0,5,6,0,6,7,18,1,0,Matches
Marvin Compper,de GER,DF,RB Leipzig,32,1985,1.0,2,2,0,2,0,2,3,66.7,1,2,2,0,0,2,8,0,Matches
Jhon Córdoba,co COL,FW,Köln,24,1993,10.6,13,10,0,11,2,1,5,20.0,4,6,2,4,1,14,9,0,Matches
Sergio Córdova,ve VEN,"FW,MF",Augsburg,19,1997,6.5,5,5,0,2,3,3,4,75.0,1,12,2,10,0,5,6,0,Matches
Danny da Costa,de GER,"DF,FW",Eint Frankfurt,24,1993,13.4,41,34,17,14,10,24,28,85.7,4,21,4,17,13,54,47,0,Matches
Mickaël Cuisance,fr FRA,"MF,FW",M'Gladbach,17,1999,13.4,31,20,16,11,4,19,29,65.5,10,22,4,18,10,41,10,1,Matches
Mahmoud Dahoud,de GER,MF,Dortmund,21,1996,12.7,38,23,11,21,6,13,30,43.3,17,18,2,16,12,50,7,0,Matches
Kevin Danso,at AUT,DF,Augsburg,18,1998,12.3,18,12,13,5,0,12,16,75.0,4,21,14,7,20,38,63,1,Matches
Palkó Dárdai,hu HUN,"FW,MF",Hertha BSC,18,1999,0.3,0,0,0,0,0,0,0,,0,0,0,0,0,0,1,0,Matches
Vladimír Darida,cz CZE,MF,Hertha BSC,26,1990,18.2,38,28,11,18,9,11,26,42.3,15,22,4,18,24,62,23,0,Matches
Thomas Delaney,dk DEN,MF,Werder Bremen,25,1991,31.1,79,61,27,46,6,36,53,67.9,17,37,12,25,43,122,74,4,Matches
Kerem Demirbay,de GER,MF,Hoffenheim,24,1993,13.5,38,30,15,17,6,12,28,42.9,16,21,3,18,14,52,21,0,Matches
Diego Demme,de GER,MF,RB Leipzig,25,1991,25.4,81,57,29,48,4,47,87,54.0,40,31,3,28,48,129,29,0,Matches
Franco Di Santo,ar ARG,"FW,MF",Schalke 04,28,1989,18.4,17,13,3,13,1,7,15,46.7,8,12,1,11,2,19,24,0,Matches
Abdou Diallo,sn SEN,DF,Mainz 05,21,1996,26.8,75,53,45,25,5,38,50,76.0,12,37,14,23,50,125,75,0,Matches
Daniel Didavi,de GER,MF,Wolfsburg,27,1990,24.9,34,19,10,19,5,14,33,42.4,19,20,1,19,7,41,12,0,Matches
Dennis Diekmeier,de GER,DF,Hamburger SV,27,1989,20.8,47,43,31,10,6,25,36,69.4,11,22,11,11,16,63,50,0,Matches
Landry Dimata,be BEL,FW,Wolfsburg,19,1997,10.0,7,6,4,3,0,5,6,83.3,1,6,2,4,2,9,5,0,Matches
Giulio Donati,it ITA,"DF,FW",Mainz 05,27,1990,25.4,56,42,30,21,5,34,50,68.0,16,38,8,30,35,91,66,1,Matches
Ji Dong-won,kr KOR,"FW,MF",Augsburg,26,1991,0.2,2,1,0,1,1,0,0,,0,1,1,0,1,3,0,0,Matches
Anastasios Donis,gr GRE,"MF,FW",Stuttgart,20,1996,10.5,20,14,10,6,4,6,8,75.0,2,2,0,2,9,29,7,0,Matches
Niklas Dorsch,de GER,MF,Bayern Munich,19,1998,1.0,1,1,0,1,0,0,2,0.0,2,0,0,0,1,2,0,0,Matches
Mohamed Dräger,tn TUN,"MF,FW",Freiburg,21,1996,0.6,0,0,0,0,0,0,1,0.0,1,1,0,1,0,0,0,0,Matches
Aleksandar Dragović,at AUT,DF,Leverkusen,26,1991,0.5,0,0,0,0,0,0,1,0.0,1,0,0,0,0,0,0,1,Matches
Josip Drmić,ch SUI,"FW,MF",M'Gladbach,24,1992,5.2,0,0,0,0,0,0,4,0.0,4,1,0,1,0,0,1,1,Matches
Rick van Drongelen,nl NED,DF,Hamburger SV,18,1998,16.0,30,25,23,7,0,21,28,75.0,7,20,11,9,19,49,58,1,Matches
Ondrej Duda,sk SVK,MF,Hertha BSC,22,1994,8.3,16,12,7,6,3,6,14,42.9,8,15,0,15,4,20,8,0,Matches
Mandela Egbo,eng ENG,"DF,MF",M'Gladbach,19,1997,0.1,0,0,0,0,0,0,0,,0,0,0,0,0,0,2,0,Matches
Johannes Eggestein,de GER,"FW,DF",Werder Bremen,19,1998,1.1,0,0,0,0,0,0,1,0.0,1,2,1,1,1,1,0,0,Matches
Maximilian Eggestein,de GER,MF,Werder Bremen,20,1996,29.9,70,48,32,34,4,34,58,58.6,24,41,6,35,40,110,51,0,Matches
Albin Ekdal,se SWE,MF,Hamburger SV,28,1989,12.3,39,28,19,19,1,18,29,62.1,11,20,3,17,21,60,19,0,Matches
Josip Elez,hr CRO,DF,Hannover 96,23,1994,8.6,12,8,9,2,1,5,9,55.6,4,9,7,2,16,28,39,1,Matches
Nico Elvedi,ch SUI,DF,M'Gladbach,20,1996,32.4,66,46,41,22,3,37,55,67.3,18,39,9,30,51,117,108,3,Matches
Breel Embolo,ch SUI,"FW,MF",Schalke 04,20,1997,10.2,14,10,3,7,4,2,9,22.2,7,13,0,13,6,20,3,0,Matches
Michael Esser,de GER,GK,Hannover 96,29,1987,3.0,0,0,0,0,0,0,1,0.0,1,0,0,0,0,0,0,0,Matches
Alexander Esswein,de GER,"FW,MF",Hertha BSC,27,1990,6.9,25,16,13,10,2,12,25,48.0,13,4,0,4,9,34,11,0,Matches
Franck Evina,cm CMR,FW,Bayern Munich,17,2000,1.2,2,2,2,0,0,2,2,100.0,0,5,0,5,0,2,0,0,Matches
Marco Fabián,mx MEX,"MF,FW",Eint Frankfurt,28,1989,4.7,5,3,2,3,0,3,4,75.0,1,2,0,2,3,8,1,0,Matches
Ralf Fährmann,de GER,GK,Schalke 04,28,1988,33.5,1,0,1,0,0,1,3,33.3,2,1,0,1,1,2,12,7,Matches
Simon Falette,gn GUI,DF,Eint Frankfurt,25,1992,24.6,34,30,23,10,1,19,31,61.3,12,37,15,22,58,92,134,1,Matches
Felipe,br BRA,DF,Hannover 96,30,1987,5.1,8,8,4,4,0,2,4,50.0,2,4,3,1,11,19,29,0,Matches
Ohis Felix Uduokhai,de GER,DF,Wolfsburg,19,1997,17.3,42,23,27,13,2,17,24,70.8,7,23,10,13,34,76,66,6,Matches
Gelson Fernandes,ch SUI,MF,Eint Frankfurt,30,1986,11.5,58,46,25,29,4,23,45,51.1,22,23,3,20,16,74,21,0,Matches
Alfreð Finnbogason,is ISL,FW,Augsburg,28,1989,20.2,18,13,7,5,6,8,15,53.3,7,15,1,14,14,32,7,0,Matches
Viktor Fischer,dk DEN,"FW,MF",Mainz 05,23,1994,3.7,4,4,2,1,1,2,5,40.0,3,2,0,2,3,7,2,0,Matches
Emil Forsberg,se SWE,MF,RB Leipzig,25,1991,15.2,24,17,3,15,6,9,21,42.9,12,19,1,18,8,32,4,0,Matches
Iver Fossum,no NOR,MF,Hannover 96,21,1996,14.5,27,19,8,13,6,10,31,32.3,21,28,3,25,15,42,14,0,Matches
Raphael Framberger,de GER,DF,Augsburg,21,1995,7.7,22,18,14,6,2,15,16,93.8,1,12,3,9,14,36,15,0,Matches
Mike Frantz,de GER,MF,Freiburg,30,1986,11.6,23,16,9,11,3,6,16,37.5,10,13,3,10,13,36,15,0,Matches
Fabian Frei,ch SUI,MF,Mainz 05,28,1989,8.9,22,15,7,12,3,8,15,53.3,7,10,0,10,16,38,17,1,Matches
Marco Friedl,at AUT,"DF,MF",Werder Bremen,19,1998,6.7,9,8,4,4,1,7,10,70.0,3,10,1,9,8,17,17,1,Matches
Marco Friedl,at AUT,MF,Bayern Munich,19,1998,0.5,0,0,0,0,0,0,0,,0,1,0,1,1,1,0,0,Matches
Chris Führich,de GER,MF,Köln,19,1998,1.1,4,3,1,2,1,2,5,40.0,3,3,0,3,0,4,1,0,Matches
Niclas Füllkrug,de GER,FW,Hannover 96,24,1993,26.5,16,11,4,8,4,10,20,50.0,10,22,3,19,8,24,30,0,Matches
Mijat Gaćinović,rs SRB,"MF,FW",Eint Frankfurt,22,1995,20.2,56,44,21,27,8,20,52,38.5,32,38,1,37,39,95,22,1,Matches
Ulisses Garcia,ch SUI,FW,Werder Bremen,21,1996,1.0,1,1,1,0,0,1,2,50.0,1,0,0,0,0,1,3,0,Matches
Jean-Philippe Gbamin,ci CIV,"MF,DF",Mainz 05,21,1995,28.8,78,63,48,26,4,43,65,66.2,22,50,10,40,50,128,80,0,Matches
Theodor Gebre Selassie,cz CZE,"DF,FW",Werder Bremen,30,1986,31.4,67,41,36,25,6,36,57,63.2,21,34,2,32,51,118,83,1,Matches
Dennis Geiger,de GER,MF,Hoffenheim,19,1998,17.6,52,36,19,31,2,16,40,40.0,24,38,2,36,15,67,7,0,Matches
Christian Gentner,de GER,MF,Stuttgart,31,1985,26.8,91,67,35,44,12,44,84,52.4,40,41,5,36,35,126,52,0,Matches
Yannick Gerhardt,de GER,"DF,MF",Wolfsburg,23,1994,13.6,37,28,18,14,5,22,34,64.7,12,25,5,20,15,52,31,0,Matches
Rafał Gikiewicz,pl POL,GK,Freiburg,29,1987,1.7,0,0,0,0,0,0,0,,0,0,0,0,0,0,0,0,Matches
Daniel Ginczek,de GER,FW,Stuttgart,26,1991,16.9,8,4,3,5,0,2,12,16.7,10,16,1,15,5,13,13,0,Matches
Matthias Ginter,de GER,DF,M'Gladbach,23,1994,34.0,48,37,27,20,1,35,45,77.8,10,40,17,23,40,88,114,1,Matches
Serge Gnabry,de GER,FW,Hoffenheim,22,1995,16.7,32,22,10,18,4,13,24,54.2,11,15,1,14,8,40,9,2,Matches
Mario Gómez,de GER,FW,Wolfsburg,32,1985,10.4,6,6,2,3,1,2,6,33.3,4,10,1,9,0,6,16,0,Matches
Mario Gómez,de GER,FW,Stuttgart,32,1985,15.4,13,11,0,8,5,2,10,20.0,8,6,0,6,4,17,17,0,Matches
Sergio Gómez,es ESP,MF,Dortmund,16,2000,0.1,0,0,0,0,0,0,0,,0,0,0,0,0,0,0,0,Matches
Jérôme Gondorf,de GER,"MF,FW",Werder Bremen,29,1988,8.9,12,9,3,9,0,4,18,22.2,14,11,2,9,6,18,12,0,Matches
Leon Goretzka,de GER,MF,Schalke 04,22,1995,22.0,50,34,22,22,6,14,50,28.0,36,45,4,41,41,91,35,0,Matches
Mario Götze,de GER,MF,Dortmund,25,1992,17.8,50,43,19,24,7,14,34,41.2,20,17,1,16,8,58,9,0,Matches
Mohamed Gouaida,tn TUN,MF,Hamburger SV,24,1993,0.6,3,3,1,1,1,0,0,,0,0,0,0,0,3,3,0,Matches
Jeffrey Gouweleeuw,nl NED,DF,Augsburg,26,1991,26.5,57,44,36,18,3,27,41,65.9,14,36,10,26,54,111,128,0,Matches
Michael Gregoritsch,at AUT,"MF,FW",Augsburg,23,1994,28.1,35,27,13,15,7,11,26,42.3,15,27,1,26,10,45,56,0,Matches
Anto Grgić,ch SUI,MF,Stuttgart,20,1996,0.1,0,0,0,0,0,0,0,,0,0,0,0,0,0,0,0,Matches
Vincenzo Grifo,it ITA,"MF,FW",M'Gladbach,24,1993,8.7,8,5,3,3,2,4,8,50.0,4,8,1,7,5,13,6,0,Matches
Florian Grillitsch,at AUT,MF,Hoffenheim,21,1995,21.0,68,46,30,36,2,35,58,60.3,23,26,3,23,39,107,25,1,Matches
Karim Guédé,sk SVK,FW,Freiburg,32,1985,0.7,2,2,2,0,0,2,2,100.0,0,1,1,0,1,3,0,0,Matches
Raphaël Guerreiro,pt POR,"DF,MF",Dortmund,23,1993,6.1,10,8,5,4,1,2,5,40.0,3,3,0,3,11,21,8,0,Matches
Josuha Guilavogui,fr FRA,MF,Wolfsburg,26,1990,26.7,65,46,43,20,2,30,50,60.0,20,34,10,24,66,131,63,0,Matches
Serhou Guirassy,gn GUI,FW,Köln,21,1996,9.5,3,3,0,2,1,1,5,20.0,4,9,1,8,1,4,11,0,Matches
Péter Gulácsi,hu HUN,GK,RB Leipzig,27,1990,33.0,0,0,0,0,0,0,2,0.0,2,0,0,0,0,0,12,4,Matches
Manuel Gulde,de GER,DF,Freiburg,26,1991,17.0,16,10,14,2,0,10,19,52.6,9,24,17,7,14,30,71,0,Matches
Christian Günter,de GER,"DF,MF",Freiburg,24,1993,34.0,73,54,45,21,7,38,63,60.3,25,38,7,31,20,93,68,0,Matches
Jonathan de Guzmán,nl NED,MF,Eint Frankfurt,29,1987,12.1,16,16,8,8,0,6,16,37.5,10,13,0,13,13,29,12,0,Matches
Janik Haberer,de GER,"MF,FW",Freiburg,23,1994,30.5,62,49,20,34,8,23,57,40.4,34,43,1,42,30,92,42,0,Matches
Alexander Hack,de GER,DF,Mainz 05,23,1993,14.3,46,34,25,19,2,24,37,64.9,13,31,18,13,26,72,87,2,Matches
Robin Hack,de GER,"FW,MF",Hoffenheim,18,1998,0.8,2,2,1,0,1,0,1,0.0,1,1,1,0,0,2,1,0,Matches
André Hahn,de GER,FW,Hamburger SV,26,1990,15.1,33,24,15,13,5,10,32,31.3,22,30,2,28,10,43,26,0,Matches
Izet Hajrović,ba BIH,"MF,FW",Werder Bremen,25,1991,2.1,1,0,1,0,0,0,1,0.0,1,0,0,0,2,3,1,0,Matches
Sébastien Haller,ci CIV,FW,Eint Frankfurt,23,1994,26.1,25,16,4,16,5,7,14,50.0,7,17,4,13,8,33,39,0,Matches
Marcel Halstenberg,de GER,DF,RB Leipzig,25,1991,13.1,29,19,16,9,4,15,19,78.9,4,15,1,14,23,52,42,1,Matches
Tim Handwerker,de GER,"MF,DF",Köln,19,1998,4.4,12,7,9,2,1,5,7,71.4,2,3,0,3,6,18,10,0,Matches
Genki Haraguchi,jp JPN,FW,Hertha BSC,26,1991,2.3,6,6,2,3,1,2,6,33.3,4,4,0,4,2,8,3,0,Matches
Amine Harit,ma MAR,"MF,FW",Schalke 04,20,1997,22.7,39,27,11,21,7,13,37,35.1,24,23,0,23,19,58,11,0,Matches
Martin Harnik,at AUT,"FW,MF",Hannover 96,30,1987,21.0,17,10,4,10,3,4,25,16.0,21,21,2,19,8,25,26,0,Matches
Makoto Hasebe,jp JPN,"DF,MF",Eint Frankfurt,33,1984,23.2,38,23,19,19,0,21,33,63.6,12,40,19,21,25,63,74,0,Matches
Kai Havertz,de GER,"MF,FW",Leverkusen,18,1999,23.8,34,23,8,23,3,12,25,48.0,13,33,2,31,19,53,23,0,Matches
Thorgan Hazard,be BEL,"MF,FW",M'Gladbach,24,1993,32.7,49,32,16,23,10,20,54,37.0,34,39,1,38,28,77,18,0,Matches
Jonas Hector,de GER,"DF,MF",Köln,27,1990,19.5,47,35,23,18,6,18,40,45.0,22,39,6,33,28,75,65,2,Matches
Dominique Heintz,de GER,DF,Köln,23,1993,31.0,60,42,47,13,0,38,64,59.4,26,35,17,18,53,113,140,0,Matches
Marcel Heller,de GER,"FW,MF",Augsburg,31,1986,14.4,37,24,21,14,2,12,28,42.9,16,22,1,21,10,47,7,0,Matches
Benjamin Henrichs,de GER,DF,Leverkusen,20,1997,14.1,42,28,23,16,3,27,43,62.8,16,23,3,20,31,73,32,0,Matches
Patrick Herrmann,de GER,"MF,FW",M'Gladbach,26,1991,12.5,29,21,9,13,7,17,29,58.6,12,13,0,13,17,46,19,0,Matches
Kaylen Hinds,eng ENG,FW,Wolfsburg,19,1998,1.0,1,1,1,0,0,0,0,,0,1,0,1,1,2,0,0,Matches
Martin Hinteregger,at AUT,DF,Augsburg,24,1992,29.5,79,51,55,22,2,47,61,77.0,14,40,27,13,49,128,135,3,Matches
Marwin Hitz,ch SUI,GK,Augsburg,29,1987,32.0,1,1,1,0,0,1,3,33.3,2,0,0,0,0,1,12,3,Matches
Nicolas Höfler,de GER,MF,Freiburg,27,1990,25.1,57,36,23,30,4,31,50,62.0,19,42,10,32,44,101,51,2,Matches
Jonas Hofmann,de GER,"MF,FW",M'Gladbach,25,1992,11.5,23,19,12,11,0,12,26,46.2,14,15,4,11,12,35,16,0,Matches
Marco Höger,de GER,MF,Köln,27,1989,18.6,60,40,31,28,1,30,64,46.9,34,35,5,30,25,85,27,1,Matches
Lucas Höler,de GER,"FW,MF",Freiburg,23,1994,10.1,24,20,8,13,3,9,24,37.5,15,10,0,10,7,31,13,0,Matches
Lewis Holtby,de GER,"MF,FW",Hamburger SV,26,1990,13.3,44,29,14,26,4,17,32,53.1,15,23,2,21,10,54,9,0,Matches
Gerrit Holtmann,ph PHI,"FW,DF",Mainz 05,22,1995,10.0,16,13,8,5,3,11,22,50.0,11,19,2,17,12,28,9,0,Matches
Jannes Horn,de GER,DF,Köln,20,1997,9.2,16,11,11,4,1,11,14,78.6,3,12,3,9,17,33,26,0,Matches
Timo Horn,de GER,GK,Köln,24,1993,34.0,3,2,3,0,0,3,6,50.0,3,0,0,0,0,3,18,2,Matches
Lukáš Hrádecký,fi FIN,GK,Eint Frankfurt,27,1989,34.0,0,0,0,0,0,0,2,0.0,2,0,0,0,0,0,23,3,Matches
Branimir Hrgota,se SWE,"MF,FW",Eint Frankfurt,24,1993,2.2,5,4,0,3,2,4,7,57.1,3,2,0,2,0,5,1,0,Matches
Timo Hübers,de GER,DF,Hannover 96,21,1996,5.0,11,10,9,2,0,9,15,60.0,6,13,8,5,9,20,31,0,Matches
Benjamin Hübner,de GER,DF,Hoffenheim,28,1989,25.7,71,56,43,27,1,31,46,67.4,15,40,18,22,51,122,114,0,Matches
Florian Hübner,de GER,DF,Hannover 96,26,1991,3.6,10,9,8,2,0,5,9,55.6,4,3,2,1,6,16,21,0,Matches
Mats Hummels,de GER,DF,Bayern Munich,28,1988,24.6,62,52,41,18,3,35,51,68.6,16,31,12,19,55,117,59,2,Matches
Aaron Hunt,de GER,"MF,FW",Hamburger SV,30,1986,23.1,36,24,12,20,4,11,37,29.7,26,20,2,18,14,50,18,2,Matches
Vedad Ibišević,ba BIH,FW,Hertha BSC,32,1984,16.1,10,8,1,5,4,4,7,57.1,3,8,1,7,4,14,23,0,Matches
Stefan Ilsanker,at AUT,"DF,MF",RB Leipzig,28,1989,14.3,37,29,23,11,3,22,39,56.4,17,23,10,13,25,62,55,1,Matches
Emiliano Insúa,ar ARG,DF,Stuttgart,28,1989,23.4,46,34,27,16,3,17,32,53.1,15,30,4,26,36,82,48,1,Matches
Pablo Insua,es ESP,DF,Schalke 04,23,1993,0.3,0,0,0,0,0,0,0,,0,1,1,0,0,0,1,0,Matches
Alexander Isak,se SWE,"FW,MF",Dortmund,17,1999,1.3,1,0,0,1,0,0,1,0.0,1,1,0,1,0,1,0,0,Matches
Tatsuya Ito,jp JPN,"MF,FW",Hamburger SV,20,1997,11.2,16,13,4,8,4,11,22,50.0,11,28,0,28,6,22,1,0,Matches
Gian-Luca Itter,de GER,DF,Wolfsburg,18,1999,4.6,19,12,15,2,2,14,22,63.6,8,6,0,6,5,24,15,0,Matches
Koo Ja-cheol,kr KOR,MF,Augsburg,28,1989,22.7,54,41,18,31,5,27,44,61.4,17,22,3,19,27,81,34,2,Matches
Paul Jaeckel,de GER,DF,Wolfsburg,19,1998,3.0,3,3,3,0,0,1,2,50.0,1,5,2,3,1,4,8,0,Matches
Kilian Jakob,de GER,FW,Augsburg,19,1998,0.6,0,0,0,0,0,0,0,,0,1,0,1,0,0,1,0,Matches
Vasilije Janjicic,ch SUI,MF,Hamburger SV,18,1998,3.6,14,11,5,9,0,2,4,50.0,2,6,1,5,3,17,5,0,Matches
Christoph Janker,de GER,"DF,MF",Augsburg,32,1985,0.9,4,3,3,1,0,2,3,66.7,1,0,0,0,1,5,4,1,Matches
Tony Jantschke,de GER,DF,M'Gladbach,27,1990,8.1,13,11,9,4,0,8,13,61.5,5,10,1,9,6,19,25,0,Matches
Rune Jarstein,no NOR,GK,Hertha BSC,32,1984,31.0,1,1,1,0,0,1,2,50.0,1,0,0,0,0,1,8,5,Matches
Bakery Jatta,gm GAM,"MF,FW",Hamburger SV,19,1998,3.3,14,12,2,12,0,4,6,66.7,2,6,1,5,3,17,5,0,Matches
Tin Jedvaj,hr CRO,DF,Leverkusen,21,1995,6.7,10,6,2,6,2,8,15,53.3,7,9,1,8,9,19,18,0,Matches
Aron Jóhannsson,us USA,"MF,FW",Werder Bremen,26,1990,3.1,4,3,2,2,0,1,7,14.3,6,3,0,3,1,5,5,0,Matches
Fabian Johnson,us USA,"MF,DF",M'Gladbach,29,1987,5.2,16,10,7,7,2,6,7,85.7,1,10,2,8,2,18,13,0,Matches
Miloš Jojić,rs SRB,MF,Köln,25,1992,16.2,36,26,18,15,3,16,40,40.0,24,31,4,27,15,51,16,0,Matches
Jonathas,br BRA,FW,Hannover 96,28,1989,7.0,7,3,2,4,1,1,2,50.0,1,3,1,2,0,7,9,0,Matches
Nigel de Jong,nl NED,MF,Mainz 05,32,1984,8.2,17,12,7,9,1,10,14,71.4,4,5,1,4,12,29,22,1,Matches
Luka Jović,rs SRB,FW,Eint Frankfurt,19,1997,10.4,5,5,0,5,0,1,3,33.3,2,6,2,4,1,6,2,0,Matches
Gideon Jung,de GER,"MF,DF",Hamburger SV,22,1994,28.6,59,41,32,24,3,22,38,57.9,16,29,12,17,38,97,71,1,Matches
Sebastian Jung,de GER,DF,Wolfsburg,27,1990,0.9,2,2,1,1,0,1,1,100.0,0,0,0,0,0,2,5,0,Matches
Zlatko Junuzović,at AUT,"MF,FW",Werder Bremen,29,1987,18.1,35,23,17,12,6,18,38,47.4,20,23,2,21,18,53,12,0,Matches
Gojko Kačar,rs SRB,DF,Augsburg,30,1987,2.5,7,6,6,1,0,3,7,42.9,4,3,2,1,4,11,7,0,Matches
Pavel Kadeřábek,cz CZE,"FW,DF",Hoffenheim,25,1992,24.4,44,30,22,18,4,20,44,45.5,24,27,8,19,34,78,45,1,Matches
Shinji Kagawa,jp JPN,MF,Dortmund,28,1989,13.0,32,22,11,14,7,18,27,66.7,9,6,0,6,6,38,2,0,Matches
Florian Kainz,at AUT,"MF,FW",Werder Bremen,24,1992,19.0,33,25,9,18,6,9,19,47.4,10,23,0,23,17,50,13,0,Matches
Dominik Kaiser,de GER,"MF,FW",RB Leipzig,28,1988,3.1,5,5,1,3,1,4,11,36.4,7,6,0,6,1,6,8,0,Matches
Salomon Kalou,ci CIV,"FW,MF",Hertha BSC,31,1985,24.5,19,11,12,5,2,9,17,52.9,8,37,1,36,10,29,29,0,Matches
Daichi Kamada,jp JPN,"MF,FW",Eint Frankfurt,20,1996,1.6,1,1,0,1,0,0,0,,0,0,0,0,1,2,0,0,Matches
Marcin Kamiński,pl POL,DF,Stuttgart,25,1992,12.6,17,14,5,11,1,12,18,66.7,6,12,3,9,30,47,55,0,Matches
Kevin Kampl,si SVN,MF,RB Leipzig,26,1990,22.4,42,33,16,20,6,16,39,41.0,23,37,2,35,33,75,33,0,Matches
Kevin Kampl,si SVN,MF,Leverkusen,26,1990,0.3,1,1,1,0,0,1,1,100.0,0,0,0,0,0,1,0,0,Matches
Bartosz Kapustka,pl POL,"FW,MF",Freiburg,20,1996,2.6,9,5,2,6,1,4,6,66.7,2,4,0,4,3,12,0,0,Matches
Kenan Karaman,tr TUR,"MF,FW",Hannover 96,23,1994,9.5,16,13,9,6,1,6,7,85.7,1,10,4,6,1,17,17,0,Matches
Florian Kath,de GER,"FW,MF",Freiburg,22,1994,7.5,15,10,3,9,3,9,17,52.9,8,9,0,9,8,23,1,0,Matches
Ole Käuper,de GER,MF,Werder Bremen,20,1997,0.8,6,5,2,4,0,1,4,25.0,3,1,0,1,2,8,0,0,Matches
Thilo Kehrer,de GER,DF,Schalke 04,20,1996,26.3,81,64,41,36,4,46,68,67.6,22,42,12,30,35,116,113,2,Matches
Naby Keïta,gn GUI,MF,RB Leipzig,22,1995,21.8,65,48,25,33,7,17,43,39.5,26,26,3,23,36,101,18,0,Matches
Marc-Oliver Kempf,de GER,DF,Freiburg,22,1995,10.0,13,12,9,4,0,5,8,62.5,3,7,7,0,17,30,52,0,Matches
Ryan Kent,eng ENG,"FW,MF",Freiburg,20,1996,2.7,4,3,2,1,1,2,5,40.0,3,6,0,6,1,5,1,0,Matches
Rani Khedira,de GER,"MF,DF",Augsburg,23,1994,25.3,62,47,25,28,9,33,47,70.2,14,41,18,23,36,98,96,0,Matches
Stefan Kießling,de GER,"DF,MF",Leverkusen,33,1984,0.9,0,0,0,0,0,0,0,,0,2,0,2,0,0,1,0,Matches
Joshua Kimmich,de GER,DF,Bayern Munich,22,1995,25.9,32,23,14,13,5,20,38,52.6,18,26,5,21,20,52,40,0,Matches
Felix Klaus,de GER,"MF,FW",Hannover 96,24,1992,22.0,48,38,20,21,7,23,50,46.0,27,29,4,25,8,56,28,0,Matches
Tim Kleindienst,de GER,"FW,DF",Freiburg,21,1995,12.6,22,15,6,12,4,4,17,23.5,13,17,3,14,6,28,21,0,Matches
Lukas Klostermann,de GER,DF,RB Leipzig,21,1996,24.3,56,41,34,18,4,28,37,75.7,9,33,6,27,33,89,79,0,Matches
Lukas Klünter,de GER,"DF,FW",Köln,21,1996,14.8,25,20,16,8,1,16,24,66.7,8,11,2,9,13,38,28,1,Matches
Robin Knoche,de GER,DF,Wolfsburg,25,1992,23.4,34,20,26,8,0,25,35,71.4,10,36,24,12,25,59,89,1,Matches
Törles Knöll,de GER,"MF,FW",Hamburger SV,19,1997,0.2,0,0,0,0,0,0,0,,0,1,0,1,0,0,0,0,Matches
Robin Koch,de GER,"MF,DF",Freiburg,21,1996,21.3,34,24,21,13,0,10,18,55.6,8,27,11,16,35,69,67,0,Matches
Kenan Kodro,ba BIH,"FW,DF",Mainz 05,23,1993,2.6,1,1,0,1,0,0,0,,0,1,0,1,3,4,0,0,Matches
Dominik Kohr,de GER,MF,Leverkusen,23,1994,18.5,49,26,20,25,4,25,41,61.0,16,39,5,34,30,79,24,0,Matches
Ibrahima Konaté,fr FRA,DF,RB Leipzig,18,1999,13.6,32,25,20,12,0,18,23,78.3,5,14,3,11,20,52,66,0,Matches
Yevhen Konoplyanka,ua UKR,"FW,MF",Schalke 04,27,1989,17.4,11,9,3,4,4,3,11,27.3,8,18,1,17,5,16,6,0,Matches
Julian Korb,de GER,"DF,MF",Hannover 96,25,1992,26.0,52,41,27,19,6,37,68,54.4,31,30,2,28,22,74,77,0,Matches
Filip Kostić,rs SRB,"FW,MF",Hamburger SV,24,1992,27.1,48,38,16,21,11,20,41,48.8,21,42,1,41,10,58,12,0,Matches
Vincent Koziello,fr FRA,MF,Köln,21,1995,8.8,28,21,6,21,1,10,21,47.6,11,9,0,9,10,38,5,1,Matches
Thomas Kraft,de GER,GK,Hertha BSC,29,1988,3.0,0,0,0,0,0,0,0,,0,0,0,0,0,0,1,0,Matches
Andrej Kramarić,hr CRO,"FW,MF",Hoffenheim,26,1991,24.8,8,6,4,3,1,3,8,37.5,5,15,0,15,6,14,7,0,Matches
Christoph Kramer,de GER,MF,M'Gladbach,26,1991,23.9,89,70,43,34,12,39,76,51.3,37,29,4,25,43,132,37,1,Matches
Max Kruse,de GER,FW,Werder Bremen,29,1988,27.3,17,12,3,10,4,5,22,22.7,17,9,0,9,11,28,4,1,Matches
Lukas Kübler,de GER,"DF,MF",Freiburg,24,1992,12.8,31,19,16,15,0,13,23,56.5,10,15,6,9,18,49,41,0,Matches
Filip Kusić,rs SRB,"DF,MF",Köln,21,1996,0.2,0,0,0,0,0,0,0,,0,0,0,0,0,0,1,0,Matches
Konrad Laimer,at AUT,"DF,MF",RB Leipzig,20,1997,14.9,57,39,31,22,4,28,57,49.1,29,37,2,35,11,68,32,0,Matches
Sebastian Langkamp,de GER,DF,Hertha BSC,29,1988,10.6,15,12,9,6,0,11,18,61.1,7,7,4,3,21,36,58,1,Matches
Sebastian Langkamp,de GER,DF,Werder Bremen,29,1988,4.6,7,3,4,3,0,4,4,100.0,0,7,5,2,8,15,18,0,Matches
Danny Latza,de GER,MF,Mainz 05,27,1989,26.1,67,48,28,33,6,33,73,45.2,40,43,8,35,26,93,47,1,Matches
Valentino Lazaro,at AUT,"MF,FW",Hertha BSC,21,1996,20.7,33,28,11,12,10,15,31,48.4,16,35,2,33,15,48,32,0,Matches
Mathew Leckie,au AUS,"FW,MF",Hertha BSC,26,1991,20.6,35,30,16,15,4,20,35,57.1,15,26,3,23,19,54,32,1,Matches
Matthias Lehmann,de GER,MF,Köln,34,1983,16.8,33,23,14,18,1,17,29,58.6,12,15,7,8,26,59,24,1,Matches
Bernd Leno,de GER,GK,Leverkusen,25,1992,33.0,0,0,0,0,0,0,1,0.0,1,0,0,0,1,1,11,2,Matches
Robert Lewandowski,pl POL,FW,Bayern Munich,28,1988,24.1,5,3,1,1,3,0,3,0.0,3,6,0,6,5,10,10,0,Matches
Philipp Lienhart,at AUT,DF,Freiburg,21,1996,9.6,16,14,12,4,0,6,17,35.3,11,14,9,5,11,27,60,0,Matches
Ademola Lookman,ng NGA,"MF,FW",RB Leipzig,19,1997,6.4,5,4,2,3,0,0,0,,0,3,0,3,2,7,2,0,Matches
Lars Lukas Mai,de GER,DF,Bayern Munich,17,2000,2.0,4,4,4,0,0,3,4,75.0,1,3,2,1,3,7,3,0,Matches
Fabian Lustenberger,ch SUI,"MF,DF",Hertha BSC,29,1988,17.6,47,34,26,20,1,21,31,67.7,10,31,12,19,24,71,74,1,Matches
Andreas Luthe,de GER,GK,Augsburg,30,1987,2.0,0,0,0,0,0,0,0,,0,0,0,0,0,0,2,0,Matches
Arne Maier,de GER,MF,Hertha BSC,18,1999,13.6,29,23,12,16,1,18,24,75.0,6,19,3,16,24,53,20,0,Matches
Sebastian Maier,de GER,MF,Hannover 96,23,1993,2.9,11,6,4,7,0,2,12,16.7,10,6,1,5,4,15,1,1,Matches
Linton Maina,de GER,MF,Hannover 96,18,1999,0.1,1,1,0,0,1,0,0,,0,0,0,0,1,2,0,0,Matches
Yunus Mallı,tr TUR,"FW,MF",Wolfsburg,25,1992,24.9,25,17,8,14,3,12,25,48.0,13,23,0,23,12,37,17,0,Matches
Orel Mangala,be BEL,MF,Stuttgart,19,1998,8.7,28,18,7,19,2,11,21,52.4,10,8,2,6,18,46,15,0,Matches
Dominic Maroh,si SVN,DF,Köln,30,1987,10.2,22,15,18,4,0,15,18,83.3,3,17,9,8,21,43,68,1,Matches
Javi Martínez,es ESP,"MF,DF",Bayern Munich,28,1988,17.9,31,22,11,15,5,9,19,47.4,10,16,5,11,33,64,40,1,Matches
Omar Mascarell,es ESP,MF,Eint Frankfurt,24,1993,8.6,20,16,8,12,0,10,18,55.6,8,14,1,13,21,41,10,0,Matches
Christian Mathenia,de GER,GK,Hamburger SV,25,1992,24.0,0,0,0,0,0,0,3,0.0,3,0,0,0,0,0,11,3,Matches
Ville Matti Steinmann,de GER,MF,Hamburger SV,22,1995,6.6,16,10,6,8,2,8,17,47.1,9,6,1,5,18,34,9,1,Matches
Mërgim Mavraj,al ALB,DF,Hamburger SV,31,1986,16.1,45,32,32,11,2,22,37,59.5,15,28,12,16,21,66,91,3,Matches
Philipp Max,de GER,DF,Augsburg,23,1993,32.9,65,47,36,19,10,34,59,57.6,25,27,8,19,33,98,65,1,Matches
Alexandru Maxim,ro ROU,MF,Mainz 05,27,1990,10.6,17,12,6,8,3,7,22,31.8,15,20,2,18,6,23,3,0,Matches
Florian Mayer,de GER,DF,M'Gladbach,19,1998,0.2,1,1,1,0,0,1,1,100.0,0,0,0,0,0,1,1,0,Matches
Weston McKennie,us USA,MF,Schalke 04,18,1998,14.0,36,23,11,21,4,13,32,40.6,19,16,2,14,20,56,32,0,Matches
Slobodan Medojević,rs SRB,MF,Eint Frankfurt,26,1990,0.3,0,0,0,0,0,0,0,,0,0,0,0,0,0,1,0,Matches
Admir Mehmedi,ch SUI,"FW,MF",Wolfsburg,26,1991,3.2,4,2,3,1,0,2,2,100.0,0,1,1,0,1,5,3,0,Matches
Admir Mehmedi,ch SUI,"DF,MF",Leverkusen,26,1991,7.8,20,18,6,11,3,4,13,30.8,9,13,0,13,13,33,5,0,Matches
Alexander Meier,de GER,FW,Eint Frankfurt,34,1983,0.0,0,0,0,0,0,0,0,,0,0,0,0,0,0,0,0,Matches
Jorge Meré,es ESP,DF,Köln,20,1997,21.0,34,23,25,9,0,23,35,65.7,12,25,13,12,34,68,110,1,Matches
Max Meyer,de GER,MF,Schalke 04,21,1995,19.2,48,38,23,21,4,19,47,40.4,28,25,3,22,54,102,11,0,Matches
Maximilian Mittelstädt,de GER,"MF,DF",Hertha BSC,20,1997,4.7,19,11,14,4,1,10,19,52.6,9,8,1,7,9,28,11,0,Matches
Niklas Moisander,fi FIN,DF,Werder Bremen,31,1985,25.0,36,28,22,13,1,24,36,66.7,12,21,9,12,38,74,98,2,Matches
Jan Morávek,cz CZE,MF,Augsburg,27,1989,7.8,41,37,17,23,1,21,36,58.3,15,19,3,16,11,52,11,0,Matches
Florian Müller,de GER,GK,Mainz 05,19,1997,5.0,0,0,0,0,0,0,0,,0,0,0,0,0,0,1,1,Matches
Nicolai Müller,de GER,"DF,MF",Hamburger SV,29,1987,1.1,2,0,0,1,1,0,0,,0,1,0,1,0,2,0,0,Matches
Thomas Müller,de GER,"MF,FW",Bayern Munich,27,1989,22.3,35,30,10,15,10,13,27,48.1,14,17,1,16,7,42,14,1,Matches
Yoshinori Mutō,jp JPN,FW,Mainz 05,25,1992,21.2,21,15,6,8,7,5,14,35.7,9,16,0,16,6,27,12,0,Matches
Yvon Mvogo,ch SUI,GK,RB Leipzig,23,1994,1.0,0,0,0,0,0,0,0,,0,0,0,0,0,0,1,1,Matches
Naldo,br BRA,DF,Schalke 04,34,1982,34.0,51,36,38,12,1,31,46,67.4,15,39,21,18,55,106,200,1,Matches
Nikolas Nartey,dk DEN,MF,Köln,17,2000,0.1,0,0,0,0,0,0,0,,0,0,0,0,0,0,0,0,Matches
Matija Nastasić,rs SRB,DF,Schalke 04,24,1993,22.1,48,38,37,10,1,28,37,75.7,9,40,22,18,36,84,85,0,Matches
Manuel Neuer,de GER,GK,Bayern Munich,31,1986,3.0,0,0,0,0,0,0,0,,0,0,0,0,0,0,1,0,Matches
Florian Niederlechner,de GER,"FW,MF",Freiburg,26,1990,7.7,8,6,1,5,2,2,5,40.0,3,5,1,4,3,11,6,0,Matches
Håvard Nordtveit,no NOR,DF,Hoffenheim,27,1990,10.8,19,16,10,9,0,13,18,72.2,5,19,8,11,10,29,50,0,Matches
Paul-Georges Ntep,cm CMR,"FW,MF",Wolfsburg,25,1992,1.8,2,2,0,0,2,0,1,0.0,1,3,1,2,1,3,0,0,Matches
Alexander Nübel,de GER,GK,Schalke 04,20,1996,0.5,0,0,0,0,0,0,0,,0,0,0,0,0,0,0,0,Matches
Philipp Ochs,de GER,"FW,DF",Hoffenheim,20,1997,0.8,5,4,1,3,1,1,2,50.0,1,0,0,0,1,6,0,0,Matches
Bastian Oczipka,de GER,"DF,MF",Schalke 04,28,1989,25.8,60,48,29,26,5,29,37,78.4,8,41,2,39,40,100,40,1,Matches
Ebenezer Ofori,gh GHA,MF,Stuttgart,22,1995,0.1,0,0,0,0,0,0,1,0.0,1,1,0,1,0,0,0,0,Matches
Kwasi Okyere Wriedt,gh GHA,MF,Bayern Munich,23,1994,0.3,2,2,1,1,0,0,0,,0,0,0,0,0,2,0,0,Matches
Paweł Olkowski,pl POL,DF,Köln,27,1990,5.0,17,12,9,8,0,5,9,55.6,4,11,2,9,3,20,17,0,Matches
Karim Onisiwo,at AUT,"DF,FW",Mainz 05,25,1992,2.8,7,5,5,1,1,3,7,42.9,4,4,0,4,1,8,8,0,Matches
Daniel Opare,gh GHA,DF,Augsburg,26,1990,15.7,31,27,20,10,1,21,27,77.8,6,14,5,9,28,59,56,0,Matches
Willi Orban,hu HUN,DF,RB Leipzig,24,1992,23.6,49,30,35,14,0,29,43,67.4,14,45,18,27,28,77,155,1,Matches
Divock Origi,be BEL,FW,Wolfsburg,22,1995,21.9,6,5,2,3,1,1,7,14.3,6,16,2,14,3,9,17,0,Matches
Yuya Osako,jp JPN,"FW,MF",Köln,27,1990,21.1,13,10,4,9,0,4,18,22.2,14,13,2,11,8,21,22,0,Matches
Victor Osimhen,ng NGA,"FW,MF",Wolfsburg,18,1998,3.2,4,4,3,1,0,2,5,40.0,3,2,1,1,2,6,7,0,Matches
Matthias Ostrzolek,de GER,"DF,MF",Hannover 96,27,1990,26.4,68,53,43,20,5,38,57,66.7,19,39,10,29,30,98,58,1,Matches
Anas Ouahim,de GER,MF,Köln,19,1997,0.2,1,1,0,1,0,1,1,100.0,0,0,0,0,0,1,0,0,Matches
Reece Oxford,eng ENG,"DF,MF",M'Gladbach,18,1998,5.1,8,6,3,4,1,3,4,75.0,1,4,0,4,9,17,26,1,Matches
Berkay Özcan,tr TUR,"MF,FW",Stuttgart,19,1998,11.1,19,10,7,9,3,7,11,63.6,4,14,2,12,3,22,8,0,Matches
Ramazan Özcan,at AUT,GK,Leverkusen,33,1984,1.0,0,0,0,0,0,0,1,0.0,1,0,0,0,0,0,0,0,Matches
Salih Özcan,tr TUR,MF,Köln,19,1998,18.6,56,42,24,29,3,28,54,51.9,26,27,5,22,29,85,22,1,Matches
Levin Öztunalı,de GER,"FW,MF",Mainz 05,21,1996,19.3,26,19,8,15,3,10,20,50.0,10,25,0,25,11,37,9,0,Matches
Kyriakos Papadopoulos,gr GRE,DF,Hamburger SV,25,1992,29.0,60,54,36,24,0,41,69,59.4,28,54,35,19,43,103,181,2,Matches
Sokratis Papastathopoulos,gr GRE,DF,Dortmund,29,1988,26.4,65,47,50,13,2,39,47,83.0,8,36,11,25,30,95,112,0,Matches
Shawn Parker,de GER,"FW,MF",Augsburg,24,1993,0.5,0,0,0,0,0,0,0,,0,0,0,0,0,0,0,0,Matches
Felix Passlack,de GER,"FW,DF",Hoffenheim,19,1998,0.7,2,2,2,0,0,2,3,66.7,1,0,0,0,0,2,2,0,Matches
Felix Passlack,de GER,DF,Dortmund,19,1998,0.1,0,0,0,0,0,0,0,,0,0,0,0,1,1,0,0,Matches
Benjamin Pavard,fr FRA,DF,Stuttgart,21,1996,34.0,55,40,40,13,2,36,47,76.6,11,59,34,25,70,125,192,1,Matches
Jiří Pavlenka,cz CZE,GK,Werder Bremen,25,1992,34.0,1,1,1,0,0,0,0,,0,2,0,2,0,1,17,4,Matches
Peter Pekarík,sk SVK,DF,Hertha BSC,30,1986,15.3,42,33,17,21,4,21,29,72.4,8,23,3,20,18,60,44,0,Matches
Nils Petersen,de GER,FW,Freiburg,28,1988,24.9,27,18,7,18,2,10,27,37.0,17,28,2,26,17,44,33,0,Matches
Maximilian Philipp,de GER,FW,Dortmund,23,1994,13.4,24,19,9,12,3,6,19,31.6,13,12,0,12,6,30,7,0,Matches
Łukasz Piszczek,pl POL,DF,Dortmund,32,1985,23.8,51,37,23,23,5,30,52,57.7,22,39,11,28,42,93,64,1,Matches
Claudio Pizarro,pe PER,"FW,MF",Köln,38,1978,6.4,11,9,3,6,2,6,9,66.7,3,10,2,8,3,14,5,0,Matches
Marko Pjaca,hr CRO,"FW,MF",Schalke 04,22,1995,2.9,5,3,2,3,0,4,6,66.7,2,3,0,3,1,6,2,0,Matches
Marvin Plattenhardt,de GER,DF,Hertha BSC,25,1992,33.0,57,43,39,15,3,35,50,70.0,15,24,7,17,27,84,92,0,Matches
Joel Pohjanpalo,fi FIN,"MF,FW",Leverkusen,22,1994,1.3,0,0,0,0,0,0,2,0.0,2,1,1,0,0,0,2,0,Matches
Eugen Polanski,pl POL,MF,Hoffenheim,31,1986,2.9,8,7,3,4,1,5,6,83.3,1,6,1,5,4,12,4,0,Matches
Julian Pollersbeck,de GER,GK,Hamburger SV,22,1994,10.0,0,0,0,0,0,0,1,0.0,1,0,0,0,0,0,4,1,Matches
Stefan Posch,at AUT,DF,Hoffenheim,20,1997,8.4,28,21,18,7,3,15,27,55.6,12,15,4,11,24,52,30,0,Matches
Yussuf Poulsen,dk DEN,FW,RB Leipzig,23,1994,18.5,23,19,2,13,8,7,12,58.3,5,24,5,19,9,32,8,0,Matches
Christian Pulisic,us USA,"FW,DF",Dortmund,18,1998,25.6,46,30,12,20,14,26,44,59.1,18,24,2,22,16,62,11,0,Matches
Robin Quaison,se SWE,FW,Mainz 05,23,1993,15.7,17,14,1,10,6,7,11,63.6,4,16,2,14,7,24,9,0,Matches
Raffael,br BRA,FW,M'Gladbach,32,1985,23.0,40,32,12,23,5,17,36,47.2,19,18,0,18,8,48,2,0,Matches
Rafinha,br BRA,DF,Bayern Munich,31,1985,20.6,39,33,24,11,4,28,47,59.6,19,17,6,11,32,71,30,0,Matches
Baba Rahman,gh GHA,DF,Schalke 04,23,1994,0.4,1,0,0,1,0,0,0,,0,2,0,2,2,3,1,0,Matches
André Ramalho,br BRA,"DF,FW",Leverkusen,25,1992,0.4,3,1,2,1,0,2,2,100.0,0,1,0,1,1,4,1,0,Matches
Milot Rashica,xk KVX,"FW,MF",Werder Bremen,21,1996,4.3,2,2,1,1,0,1,8,12.5,7,3,0,3,3,5,4,0,Matches
Konstantin Rausch,ru RUS,DF,Köln,27,1990,10.3,21,16,13,7,1,11,26,42.3,15,9,2,7,17,38,25,0,Matches
Yoric Ravet,fr FRA,"FW,MF",Freiburg,27,1989,5.5,9,7,3,6,0,3,7,42.9,4,7,0,7,3,12,6,0,Matches
Ante Rebić,hr CRO,FW,Eint Frankfurt,23,1993,19.5,37,29,7,21,9,7,24,29.2,17,27,2,25,6,43,13,0,Matches
Fabian Reese,de GER,"FW,MF",Schalke 04,19,1997,0.8,2,2,1,1,0,1,2,50.0,1,1,0,1,2,4,1,0,Matches
Karim Rekik,nl NED,DF,Hertha BSC,22,1994,25.6,38,29,32,6,0,24,26,92.3,2,27,11,16,28,66,116,2,Matches
Panagiotis Retsos,gr GRE,DF,Leverkusen,18,1998,19.1,48,40,32,14,2,33,46,71.7,13,29,8,21,29,77,47,0,Matches
Marco Reus,de GER,"MF,FW",Dortmund,28,1989,10.3,16,8,2,12,2,5,12,41.7,7,16,3,13,4,20,9,0,Matches
Elvis Rexhbeçaj,de GER,"DF,MF",Wolfsburg,19,1997,1.4,4,2,1,2,1,1,1,100.0,0,3,0,3,2,6,3,0,Matches
Franck Ribéry,fr FRA,"FW,MF",Bayern Munich,34,1983,13.4,19,16,9,5,5,13,17,76.5,4,11,0,11,7,26,3,0,Matches
Marco Richter,de GER,FW,Augsburg,19,1997,7.2,17,14,8,8,1,8,17,47.1,9,5,1,4,1,18,10,0,Matches
Birk Risa,no NOR,FW,Köln,19,1998,0.9,1,1,0,1,0,0,3,0.0,3,2,1,1,0,1,0,0,Matches
Marcel Risse,de GER,"DF,MF",Köln,27,1989,13.0,21,14,17,4,0,11,19,57.9,8,21,3,18,6,27,10,2,Matches
Arjen Robben,nl NED,"FW,MF",Bayern Munich,33,1984,16.7,14,11,1,7,6,4,12,33.3,8,9,0,9,4,18,4,0,Matches
James Rodríguez,co COL,"MF,FW",Bayern Munich,26,1991,18.0,35,27,10,15,10,15,30,50.0,15,16,1,15,12,47,4,0,Matches
Sebastian Rudy,de GER,MF,Bayern Munich,27,1990,16.8,50,40,12,33,5,28,55,50.9,27,11,1,10,18,68,7,1,Matches
Lukas Rupp,de GER,"MF,FW",Hoffenheim,26,1991,12.9,36,32,18,14,4,19,36,52.8,17,18,0,18,13,49,13,2,Matches
Marco Russ,de GER,DF,Eint Frankfurt,31,1985,12.7,17,11,9,8,0,13,19,68.4,6,23,11,12,24,41,66,0,Matches
Marcel Sabitzer,at AUT,"MF,FW",RB Leipzig,23,1994,19.9,38,28,12,20,6,23,49,46.9,26,23,2,21,24,62,21,1,Matches
Nuri Şahin,tr TUR,MF,Dortmund,28,1988,13.6,40,34,9,28,3,15,39,38.5,24,12,0,12,20,60,29,1,Matches
Gōtoku Sakai,jp JPN,"DF,MF",Hamburger SV,26,1991,25.4,50,40,25,18,7,22,47,46.8,25,40,12,28,44,94,55,0,Matches
Carlos Salcedo,mx MEX,DF,Eint Frankfurt,23,1993,17.9,26,22,16,9,1,19,29,65.5,10,28,12,16,21,47,94,1,Matches
Sejad Salihović,ba BIH,MF,Hamburger SV,32,1984,4.1,7,5,3,3,1,0,3,0.0,3,5,0,5,5,12,1,0,Matches
Jairo Samperio,es ESP,"MF,FW",Mainz 05,24,1993,0.4,1,1,0,1,0,1,1,100.0,0,0,0,0,0,1,0,0,Matches
Jadon Sancho,eng ENG,FW,Dortmund,17,2000,7.7,5,5,2,2,1,2,7,28.6,5,8,0,8,5,10,2,0,Matches
Lamine Sané,sn SEN,DF,Werder Bremen,30,1987,8.7,19,14,15,4,0,8,10,80.0,2,8,6,2,20,39,49,1,Matches
Salif Sané,sn SEN,DF,Hannover 96,26,1990,32.0,57,43,46,10,1,40,64,62.5,24,49,29,20,57,114,238,6,Matches
Douglas Santos,br BRA,DF,Hamburger SV,23,1994,26.4,90,60,53,34,3,50,87,57.5,37,63,2,61,56,146,96,1,Matches
Julian Schieber,de GER,"MF,FW",Hertha BSC,28,1989,0.6,1,1,0,0,1,1,1,100.0,0,1,0,1,0,1,2,0,Matches
Sven Schipplock,de GER,"FW,MF",Hamburger SV,28,1988,3.8,7,6,1,5,1,0,1,0.0,1,4,0,4,1,8,3,0,Matches
Marcel Schmelzer,de GER,DF,Dortmund,29,1988,16.6,35,27,21,12,2,20,30,66.7,10,27,6,21,30,65,57,1,Matches
Jonathan Schmid,fr FRA,"DF,FW",Augsburg,27,1990,16.4,23,16,6,13,4,11,18,61.1,7,16,1,15,10,33,35,1,Matches
Manuel Schmiedebach,de GER,MF,Hannover 96,28,1988,1.8,5,5,5,0,0,4,9,44.4,5,2,0,2,5,10,6,0,Matches
Benno Schmitz,de GER,DF,RB Leipzig,22,1994,0.9,3,2,2,1,0,2,3,66.7,1,0,0,0,0,3,1,0,Matches
Alessandro Schöpf,at AUT,"DF,FW",Schalke 04,23,1994,9.0,22,17,10,9,3,11,23,47.8,12,16,0,16,15,37,13,1,Matches
Nico Schulz,de GER,"FW,MF",Hoffenheim,24,1993,19.8,40,29,17,14,9,20,27,74.1,7,33,5,28,23,63,24,0,Matches
André Schürrle,de GER,FW,Dortmund,26,1990,13.7,22,19,8,7,7,9,18,50.0,9,13,1,12,7,29,7,1,Matches
Julian Schuster,de GER,"DF,MF",Freiburg,32,1985,14.5,14,10,6,7,1,6,11,54.5,5,17,10,7,19,33,56,0,Matches
Pirmin Schwegler,ch SUI,MF,Hannover 96,30,1987,25.8,81,57,25,55,1,42,70,60.0,28,33,9,24,49,130,46,1,Matches
Alexander Schwolow,de GER,GK,Freiburg,25,1992,32.3,0,0,0,0,0,0,1,0.0,1,0,0,0,0,0,9,1,Matches
Davie Selke,de GER,FW,Hertha BSC,22,1995,21.0,13,10,1,5,7,4,9,44.4,5,26,5,21,2,15,20,1,Matches
Suat Serdar,de GER,MF,Mainz 05,20,1997,18.9,59,47,21,26,12,27,64,42.2,37,38,3,35,21,80,17,1,Matches
Meritan Shabani,al ALB,FW,Bayern Munich,18,1999,0.6,2,1,1,0,1,1,2,50.0,1,1,0,1,0,2,0,1,Matches
Vincent Sierro,ch SUI,"MF,FW",Freiburg,21,1995,2.4,8,6,2,6,0,4,9,44.4,5,2,1,1,4,12,0,0,Matches
Tobias Sippel,de GER,GK,M'Gladbach,29,1988,4.8,1,1,1,0,0,1,2,50.0,1,0,0,0,0,1,5,1,Matches
Yann Sommer,ch SUI,GK,M'Gladbach,28,1988,29.2,0,0,0,0,0,0,0,,0,0,0,0,3,3,6,3,Matches
Oliver Sorg,de GER,"DF,MF",Hannover 96,27,1990,18.7,46,28,27,18,1,23,53,43.4,30,24,7,17,42,88,71,0,Matches
Çağlar Söyüncü,tr TUR,DF,Freiburg,21,1996,23.9,42,26,26,15,1,15,26,57.7,11,30,20,10,54,96,91,2,Matches
Kostas Stafylidis,gr GRE,"FW,DF",Augsburg,23,1993,0.4,1,1,1,0,0,0,0,,0,1,0,1,0,1,2,0,Matches
Benjamin Stambouli,fr FRA,"DF,MF",Schalke 04,26,1990,24.4,95,75,45,48,2,49,74,66.2,25,39,7,32,64,159,76,1,Matches
Caleb Stanko,us USA,DF,Freiburg,24,1993,2.1,2,2,1,1,0,1,2,50.0,1,3,0,3,1,3,8,0,Matches
Niklas Stark,de GER,"DF,MF",Hertha BSC,22,1995,24.6,49,31,32,17,0,22,30,73.3,8,39,14,25,34,83,165,0,Matches
Tom Starke,de GER,GK,Bayern Munich,36,1981,2.0,0,0,0,0,0,0,0,,0,0,0,0,0,0,0,0,Matches
Renato Steffen,ch SUI,"FW,MF",Wolfsburg,25,1991,7.3,10,9,6,3,1,8,12,66.7,4,6,0,6,5,15,6,0,Matches
Marc Stendera,de GER,MF,Eint Frankfurt,21,1995,4.1,23,20,6,15,2,8,20,40.0,12,10,1,9,8,31,2,0,Matches
Pascal Stenzel,de GER,"MF,DF",Freiburg,21,1996,21.6,62,45,35,25,2,34,57,59.6,23,20,3,17,35,97,51,1,Matches
Lars Stindl,de GER,"FW,MF",M'Gladbach,28,1988,30.3,52,39,11,29,12,14,38,36.8,24,53,4,49,31,83,32,1,Matches
Valentin Stocker,ch SUI,MF,Hertha BSC,28,1989,0.6,1,0,0,1,0,0,0,,0,1,0,1,0,1,0,0,Matches
Tobias Strobl,de GER,MF,M'Gladbach,27,1990,1.3,3,1,0,2,1,0,1,0.0,1,2,0,2,6,9,2,0,Matches
Neven Subotić,rs SRB,DF,Dortmund,28,1988,3.0,9,9,5,3,1,6,7,85.7,1,6,2,4,5,14,16,0,Matches
Niklas Süle,de GER,DF,Bayern Munich,21,1995,21.4,34,25,25,7,2,24,31,77.4,7,24,16,8,33,67,58,0,Matches
Ádám Szalai,hu HUN,FW,Hoffenheim,29,1987,10.0,8,7,1,4,3,2,5,40.0,3,9,2,7,0,8,10,0,Matches
Frederik Sørensen,dk DEN,DF,Köln,25,1992,22.2,56,45,40,14,2,30,41,73.2,11,35,17,18,37,93,130,3,Matches
Jonathan Tah,de GER,DF,Leverkusen,21,1996,27.0,47,34,35,12,0,30,38,78.9,8,22,13,9,34,81,112,2,Matches
Taleb Tawatha,il ISR,"DF,MF",Eint Frankfurt,25,1992,4.9,12,7,7,5,0,5,9,55.6,4,7,1,6,6,18,18,0,Matches
Simon Terodde,de GER,FW,Stuttgart,29,1988,10.6,9,6,1,7,1,2,5,40.0,3,8,2,6,5,14,8,0,Matches
Simon Terodde,de GER,FW,Köln,29,1988,12.9,11,9,3,8,0,4,11,36.4,7,3,0,3,4,15,7,0,Matches
Marco Terrazzino,de GER,"MF,FW",Freiburg,26,1991,16.5,31,24,12,13,6,21,39,53.8,18,16,0,16,9,40,19,0,Matches
Cedric Teuchert,de GER,FW,Schalke 04,20,1997,0.4,0,0,0,0,0,0,0,,0,1,0,1,0,0,0,0,Matches
Erik Thommy,de GER,FW,Augsburg,22,1994,1.9,6,5,1,3,2,3,8,37.5,5,2,0,2,5,11,0,0,Matches
Erik Thommy,de GER,MF,Stuttgart,22,1994,10.9,19,11,7,7,5,9,17,52.9,8,17,2,15,9,28,8,1,Matches
Marcel Tisserand,cd COD,DF,Wolfsburg,24,1993,13.9,15,10,10,4,1,7,14,50.0,7,18,13,5,31,46,50,0,Matches
Corentin Tolisso,fr FRA,MF,Bayern Munich,22,1994,17.5,33,22,8,18,7,14,32,43.8,18,13,3,10,16,49,8,0,Matches
Jeremy Toljan,de GER,"DF,FW",Hoffenheim,22,1994,2.0,3,1,1,2,0,2,3,66.7,1,3,0,3,0,3,3,0,Matches
Jeremy Toljan,de GER,DF,Dortmund,22,1994,13.5,29,20,17,11,1,19,32,59.4,13,17,2,15,12,41,45,0,Matches
Ömer Toprak,tr TUR,DF,Dortmund,28,1989,22.4,36,25,29,6,1,26,29,89.7,3,27,16,11,21,57,104,1,Matches
Jordan Torunarigha,de GER,DF,Hertha BSC,19,1997,7.4,18,12,16,2,0,7,13,53.8,6,20,13,7,23,41,43,1,Matches
Ibrahima Traoré,gn GUI,MF,M'Gladbach,29,1988,2.2,4,2,2,2,0,4,7,57.1,3,2,0,2,0,4,1,0,Matches
Philipp Tschauner,de GER,GK,Hannover 96,31,1985,31.0,1,0,1,0,0,1,2,50.0,1,2,0,2,0,1,8,5,Matches
Anthony Ujah,ng NGA,FW,Mainz 05,26,1990,2.3,4,3,0,2,2,1,1,100.0,0,2,0,2,0,4,6,0,Matches
Sven Ulreich,de GER,GK,Bayern Munich,28,1988,29.0,1,0,1,0,0,1,1,100.0,0,0,0,0,3,4,6,1,Matches
Dayot Upamecano,fr FRA,DF,RB Leipzig,18,1998,25.2,57,43,36,17,4,31,45,68.9,14,32,9,23,55,112,141,1,Matches
Mark Uth,de GER,FW,Hoffenheim,25,1991,24.2,32,23,4,21,7,5,22,22.7,17,30,3,27,9,41,19,0,Matches
Josha Vagnoman,de GER,MF,Hamburger SV,16,2000,0.2,1,1,0,1,0,1,1,100.0,0,0,0,0,0,1,0,0,Matches
Miloš Veljković,rs SRB,DF,Werder Bremen,21,1995,29.5,45,32,30,13,2,30,52,57.7,22,34,12,22,34,79,134,1,Matches
Paul Verhaegh,nl NED,DF,Wolfsburg,33,1983,29.0,45,38,21,22,2,24,33,72.7,9,38,10,28,33,78,60,0,Matches
Jannik Vestergaard,dk DEN,DF,M'Gladbach,24,1992,32.0,58,41,43,15,0,32,48,66.7,16,55,39,16,40,98,161,3,Matches
Arturo Vidal,cl CHI,MF,Bayern Munich,30,1987,16.2,69,51,36,28,5,33,69,47.8,36,22,1,21,28,97,20,1,Matches
Julio Villalba,py PAR,DF,M'Gladbach,18,1998,0.1,0,0,0,0,0,0,0,,0,0,0,0,0,0,0,0,Matches
Kevin Vogt,de GER,DF,Hoffenheim,25,1991,31.0,38,28,30,7,1,23,34,67.6,11,37,23,14,25,63,114,2,Matches
Kevin Volland,de GER,"FW,MF",Leverkusen,25,1992,28.8,23,20,7,8,8,11,26,42.3,15,16,1,15,3,26,35,0,Matches
Sandro Wagner,de GER,FW,Hoffenheim,29,1987,9.7,8,5,3,5,0,5,6,83.3,1,11,3,8,3,11,13,0,Matches
Sandro Wagner,de GER,FW,Bayern Munich,29,1987,8.1,9,6,3,5,1,1,1,100.0,0,4,0,4,2,11,1,0,Matches
Walace,br BRA,MF,Hamburger SV,22,1995,14.6,38,25,13,23,2,19,44,43.2,25,25,3,22,21,59,14,1,Matches
Luca Waldschmidt,de GER,"MF,FW",Hamburger SV,21,1996,8.8,10,6,1,8,1,3,10,30.0,7,11,0,11,3,13,2,0,Matches
Roman Weidenfeller,de GER,GK,Dortmund,36,1980,1.0,0,0,0,0,0,0,0,,0,0,0,0,0,0,0,1,Matches
Julian Weigl,de GER,MF,Dortmund,21,1995,21.6,69,49,20,42,7,42,66,63.6,24,26,6,20,34,103,29,2,Matches
Mitchell Weiser,de GER,"DF,FW",Hertha BSC,23,1994,22.0,54,43,20,27,7,17,38,44.7,21,28,1,27,44,98,37,1,Matches
Wendell,br BRA,DF,Leverkusen,24,1993,23.5,54,41,29,20,5,32,58,55.2,26,44,8,36,28,82,58,0,Matches
Oscar Wendt,se SWE,DF,M'Gladbach,31,1985,27.3,54,40,31,19,4,30,45,66.7,15,46,12,34,27,81,71,0,Matches
Timo Werner,de GER,FW,RB Leipzig,21,1996,27.7,16,11,2,8,6,3,19,15.8,16,26,0,26,7,23,11,0,Matches
Jetro Willems,nl NED,"FW,DF",Eint Frankfurt,23,1994,18.5,55,42,28,23,4,27,42,64.3,15,31,1,30,20,75,53,0,Matches
William,br BRA,DF,Wolfsburg,22,1995,17.9,76,61,43,26,7,46,86,53.5,40,41,6,35,46,122,65,1,Matches
Marius Wolf,de GER,"MF,FW",Eint Frankfurt,22,1995,26.3,37,28,15,18,4,18,46,39.1,28,45,1,44,27,64,46,0,Matches
Bobby Wood,us USA,"FW,MF",Hamburger SV,24,1992,17.9,13,8,2,4,7,3,9,33.3,6,4,0,4,2,15,13,0,Matches
Andriy Yarmolenko,ua UKR,"FW,MF",Dortmund,27,1989,11.5,17,12,6,6,5,7,16,43.8,9,4,0,4,7,24,4,0,Matches
Dan-Axel Zagadou,fr FRA,DF,Dortmund,18,1999,7.3,9,8,5,3,1,6,7,85.7,1,9,0,9,11,20,20,1,Matches
Denis Zakaria,ch SUI,MF,M'Gladbach,20,1996,25.5,74,48,38,32,4,40,61,65.6,21,52,9,43,45,119,40,1,Matches
Robin Zentner,de GER,GK,Mainz 05,22,1994,15.0,0,0,0,0,0,0,1,0.0,1,0,0,0,1,1,10,2,Matches
Ron-Robert Zieler,de GER,GK,Stuttgart,28,1989,34.0,1,1,1,0,0,1,1,100.0,0,2,0,2,1,2,14,5,Matches
Matthias Zimmermann,de GER,DF,Stuttgart,25,1992,0.9,3,1,2,1,0,3,4,75.0,1,0,0,0,1,4,5,1,Matches
Simon Zoller,de GER,"MF,FW",Köln,26,1991,10.7,11,7,3,6,2,7,10,70.0,3,5,2,3,8,19,9,0,Matches
Steven Zuber,ch SUI,"FW,DF",Hoffenheim,25,1991,15.9,40,30,22,13,5,26,41,63.4,15,18,3,15,17,57,27,0,Matches
Robert Žulj,at AUT,"MF,FW",Hoffenheim,25,1992,2.3,3,3,1,2,0,1,1,100.0,0,3,0,3,0,3,2,0,Matches
