player,nationality,position,team,age,birth_year,minutes_90s,tackles,tackles_won,tackles_def_3rd,tackles_mid_3rd,tackles_att_3rd,challenge_tackles,challenges,challenge_tackles_pct,challenges_lost,blocks,blocked_shots,blocked_passes,interceptions,tackles_interceptions,clearances,errors,matches
Issah Abbas,gh GHA,"DF,FW",Mainz 05,21,1998,0.2,0,0,0,0,0,0,0,,0,0,0,0,0,0,0,0,Matches
David Abraham,ar ARG,DF,Eint Frankfurt,34,1986,13.6,18,12,13,3,2,11,17,64.7,6,13,4,9,17,35,34,0,Matches
Amir Abrashi,al ALB,"MF,DF",Freiburg,30,1990,0.7,1,1,1,0,0,0,0,,0,1,1,0,2,3,1,0,Matches
Ragnar Ache,de GER,"FW,DF",Eint Frankfurt,22,1998,1.1,2,0,0,1,1,0,0,,0,1,0,1,1,3,1,0,Matches
Tyler Adams,us USA,"MF,DF",RB Leipzig,21,1999,20.6,35,24,12,15,8,17,31,54.8,14,22,5,17,29,64,30,0,Matches
Sargis Adamyan,am ARM,"FW,MF",Hoffenheim,27,1993,5.3,9,4,4,3,2,7,14,50.0,7,2,0,2,6,15,1,0,Matches
Felix Agu,de GER,DF,Werder Bremen,20,1999,7.8,20,9,10,9,1,10,18,55.6,8,14,3,11,12,32,18,0,Matches
Naouirou Ahamada,fr FRA,MF,Stuttgart,18,2002,2.8,4,1,3,1,0,1,1,100.0,0,2,0,2,1,5,1,0,Matches
Manuel Akanji,ch SUI,DF,Dortmund,25,1995,26.1,41,22,23,12,6,19,31,61.3,12,23,10,13,49,90,70,1,Matches
Kevin Akpoguma,ng NGA,DF,Hoffenheim,25,1995,13.2,18,12,11,6,1,8,14,57.1,6,28,15,13,13,31,32,2,Matches
David Alaba,at AUT,"DF,MF",Bayern Munich,28,1992,29.7,37,21,14,19,4,17,32,53.1,15,29,13,16,43,80,60,0,Matches
Lucas Alario,ar ARG,FW,Leverkusen,27,1992,13.8,8,2,2,5,1,2,4,50.0,2,9,1,8,2,10,10,0,Matches
Omar Alderete,py PAR,DF,Hertha BSC,23,1996,14.4,16,10,11,5,0,7,16,43.8,9,14,10,4,21,37,61,1,Matches
Nadiem Amiri,de GER,MF,Leverkusen,23,1996,21.0,12,7,4,8,0,7,33,21.2,26,18,3,15,12,24,7,0,Matches
Sebastian Andersson,se SWE,FW,Köln,29,1991,12.5,3,2,0,3,0,1,8,12.5,7,10,3,7,2,5,9,0,Matches
Robert Andrich,de GER,MF,Union Berlin,25,1994,28.1,51,24,22,27,2,24,53,45.3,29,40,6,34,51,102,31,2,Matches
Angeliño,es ESP,"DF,FW",RB Leipzig,23,1997,24.0,31,19,10,18,3,13,24,54.2,11,22,1,21,30,61,40,0,Matches
Waldemar Anton,de GER,DF,Stuttgart,24,1996,30.1,31,20,17,14,0,12,31,38.7,19,28,18,10,47,78,114,0,Matches
Charles Aránguiz,cl CHI,MF,Leverkusen,31,1989,18.5,41,23,16,21,4,17,43,39.5,26,32,4,28,33,74,17,0,Matches
Santiago Arias,co COL,DF,Leverkusen,28,1992,1.0,2,1,0,1,1,1,1,100.0,0,0,0,0,1,3,4,0,Matches
Maximilian Arnold,de GER,MF,Wolfsburg,26,1994,28.7,47,32,20,26,1,18,49,36.7,31,24,3,21,49,96,57,0,Matches
Toluwalase Arokodare,ng NGA,"FW,MF",Köln,19,2000,1.2,1,1,0,0,1,0,0,,0,1,0,1,1,2,0,0,Matches
Santiago Ascacíbar,ar ARG,MF,Hertha BSC,23,1997,8.5,30,15,15,14,1,15,28,53.6,13,23,2,21,13,43,14,0,Matches
Ludwig Augustinsson,se SWE,"DF,FW",Werder Bremen,26,1994,21.7,37,20,19,14,4,17,29,58.6,12,21,7,14,20,57,62,0,Matches
Taiwo Awoniyi,ng NGA,FW,Union Berlin,22,1997,15.1,5,3,2,3,0,1,14,7.1,13,9,0,9,3,8,4,0,Matches
Mehmet Aydin,de GER,DF,Schalke 04,18,2002,5.6,15,7,9,6,0,4,10,40.0,6,6,1,5,6,21,16,0,Matches
Leon Bailey,jm JAM,"FW,MF",Leverkusen,22,1997,23.8,14,8,3,7,4,4,15,26.7,11,13,0,13,9,23,3,0,Matches
Ridle Baku,de GER,"FW,DF",Wolfsburg,22,1998,29.8,50,31,20,20,10,22,53,41.5,31,54,4,50,40,90,33,1,Matches
Ridle Baku,de GER,DF,Mainz 05,22,1998,2.0,4,2,3,1,0,2,6,33.3,4,3,1,2,3,7,6,0,Matches
Philipp Bargfrede,de GER,MF,Werder Bremen,31,1989,0.3,0,0,0,0,0,0,0,,0,0,0,0,0,0,3,0,Matches
Aymen Barkok,ma MAR,"MF,DF",Eint Frankfurt,22,1998,10.9,29,15,11,9,9,10,31,32.3,21,15,1,14,10,39,9,1,Matches
Leandro Barreiro Martins,lu LUX,MF,Mainz 05,20,2000,25.6,58,32,19,26,13,20,50,40.0,30,34,9,25,57,115,55,0,Matches
Jacob Barrett Laursen,dk DEN,DF,Arminia,25,1994,12.3,23,12,13,8,2,10,16,62.5,6,14,4,10,24,47,37,0,Matches
Oliver Baumann,de GER,GK,Hoffenheim,30,1990,31.0,0,0,0,0,0,0,1,0.0,1,0,0,0,2,2,14,0,Matches
Julian Baumgartlinger,at AUT,MF,Leverkusen,32,1988,11.9,43,20,14,26,3,16,31,51.6,15,12,0,12,12,55,10,1,Matches
Christoph Baumgartner,at AUT,"MF,FW",Hoffenheim,20,1999,26.3,44,31,13,24,7,14,51,27.5,37,40,8,32,24,68,24,0,Matches
Noah Joel Sarenren Bazee,ng NGA,"FW,MF",Augsburg,23,1996,0.4,0,0,0,0,0,0,1,0.0,1,0,0,0,1,1,0,0,Matches
Ihlas Bebou,tg TOG,"FW,MF",Hoffenheim,26,1994,24.4,24,9,5,10,9,8,14,57.1,6,18,4,14,17,41,16,0,Matches
Sheraldo Becker,sr SUR,"FW,MF",Union Berlin,25,1995,12.3,5,4,2,2,1,3,5,60.0,2,4,0,4,6,11,7,0,Matches
Timo Becker,de GER,DF,Schalke 04,23,1997,18.2,34,23,28,6,0,16,25,64.0,9,18,4,14,22,56,58,0,Matches
Brian Behrendt,de GER,DF,Arminia,28,1991,0.9,0,0,0,0,0,0,1,0.0,1,0,0,0,0,0,1,0,Matches
Maximilian Beier,de GER,"FW,DF",Hoffenheim,17,2002,0.1,0,0,0,0,0,0,1,0.0,1,0,0,0,0,0,0,0,Matches
Ishak Belfodil,dz ALG,"FW,MF",Hoffenheim,28,1992,6.6,3,2,0,0,3,0,2,0.0,2,1,0,1,1,4,3,0,Matches
Stefan Bell,de GER,DF,Mainz 05,28,1991,14.1,24,18,15,9,0,14,23,60.9,9,19,11,8,27,51,76,1,Matches
Karim Bellarabi,de GER,"FW,MF",Leverkusen,30,1990,8.9,12,10,3,4,5,4,17,23.5,13,12,0,12,12,24,4,0,Matches
Jude Bellingham,eng ENG,MF,Dortmund,17,2003,18.9,49,31,11,29,9,19,46,41.3,27,37,5,32,24,73,13,0,Matches
Lars Bender,de GER,DF,Leverkusen,31,1989,10.4,19,13,12,6,1,9,21,42.9,12,19,5,14,16,35,19,0,Matches
Sven Bender,de GER,DF,Leverkusen,31,1989,13.0,17,9,8,8,1,7,20,35.0,13,20,9,11,21,38,41,1,Matches
László Bénes,sk SVK,MF,Augsburg,22,1997,7.3,8,6,4,4,0,2,8,25.0,6,6,2,4,7,15,1,1,Matches
László Bénes,sk SVK,MF,M'Gladbach,22,1997,1.7,6,2,5,1,0,2,4,50.0,2,0,0,0,2,8,1,0,Matches
Ramy Bensebaini,dz ALG,DF,M'Gladbach,25,1995,20.1,43,24,27,13,3,26,42,61.9,16,39,7,32,47,90,66,0,Matches
Nabil Bentaleb,dz ALG,MF,Schalke 04,25,1994,6.1,14,8,7,6,1,4,15,26.7,11,5,2,3,6,20,8,0,Matches
Jordan Beyer,de GER,DF,M'Gladbach,20,2000,2.1,2,1,2,0,0,1,2,50.0,1,5,4,1,5,7,5,0,Matches
Bartosz Białek,pl POL,"FW,MF",Wolfsburg,18,2001,3.0,6,5,1,4,1,4,4,100.0,0,5,1,4,3,9,4,0,Matches
Ermin Bičakčić,ba BIH,DF,Hoffenheim,30,1990,1.4,1,1,0,1,0,1,1,100.0,0,1,1,0,3,4,9,0,Matches
Leonardo Bittencourt,de GER,"MF,FW",Werder Bremen,26,1993,16.8,58,32,24,28,6,16,51,31.4,35,29,2,27,13,71,10,0,Matches
Jérôme Boateng,de GER,DF,Bayern Munich,31,1988,26.3,26,16,17,8,1,14,32,43.8,18,24,17,7,40,66,63,1,Matches
Jean-Paul Boëtius,nl NED,"MF,FW",Mainz 05,26,1994,22.9,42,28,13,15,14,17,47,36.2,30,37,3,34,33,75,14,0,Matches
Melayro Bogarde,nl NED,"DF,MF",Hoffenheim,18,2002,3.1,7,3,3,3,1,5,9,55.6,4,0,0,0,5,12,1,0,Matches
Elias Bördner,de GER,GK,Eint Frankfurt,18,2002,1.0,1,0,1,0,0,1,1,100.0,0,0,0,0,2,3,1,0,Matches
Dennis Borkowski,de GER,"MF,FW",RB Leipzig,18,2002,0.1,0,0,0,0,0,0,0,,0,1,0,1,0,0,0,0,Matches
Sebastiaan Bornauw,be BEL,DF,Köln,21,1999,23.1,29,20,25,4,0,14,25,56.0,11,33,26,7,40,69,104,0,Matches
Nassim Boujellab,ma MAR,"MF,FW",Schalke 04,21,1999,6.7,13,9,2,10,1,2,12,16.7,10,10,3,7,7,20,9,0,Matches
Dedryck Boyata,be BEL,DF,Hertha BSC,29,1990,17.2,14,7,10,3,1,7,15,46.7,8,23,20,3,26,40,68,1,Matches
Can Bozdogan,de GER,"MF,FW",Schalke 04,19,2001,7.2,13,5,6,6,1,4,15,26.7,11,10,2,8,7,20,5,0,Matches
Julian Brandt,de GER,"FW,MF",Dortmund,24,1996,16.6,27,14,13,9,5,12,43,27.9,31,25,1,24,17,44,7,1,Matches
Fabian Bredlow,de GER,GK,Stuttgart,25,1995,1.0,0,0,0,0,0,0,0,,0,0,0,0,0,0,0,0,Matches
Josip Brekalo,hr CRO,FW,Wolfsburg,22,1998,20.2,22,10,10,7,5,8,29,27.6,21,18,0,18,17,39,3,1,Matches
Joshua Brenet,nl NED,DF,Hoffenheim,26,1994,0.0,0,0,0,0,0,0,0,,0,0,0,0,0,0,0,0,Matches
John Brooks,us USA,DF,Wolfsburg,27,1993,30.8,47,29,33,14,0,30,54,55.6,24,35,10,25,55,102,134,0,Matches
Daniel Brosinski,de GER,"DF,FW",Mainz 05,32,1988,15.9,19,14,10,7,2,12,31,38.7,19,18,1,17,14,33,33,0,Matches
Cédric Brunner,ch SUI,DF,Arminia,26,1994,29.5,42,22,24,15,3,27,40,67.5,13,30,10,20,42,84,96,0,Matches
Jacob Bruun Larsen,dk DEN,"MF,FW",Hoffenheim,21,1998,1.0,0,0,0,0,0,0,0,,0,0,0,0,0,0,0,0,Matches
Marius Bülter,de GER,"FW,MF",Union Berlin,27,1993,10.9,15,8,6,6,3,5,17,29.4,12,17,2,15,12,27,11,0,Matches
Jonathan Burkardt,de GER,"FW,MF",Mainz 05,20,2000,15.3,27,13,15,10,2,11,19,57.9,8,20,3,17,8,35,15,0,Matches
Nishan Burkart,ch SUI,MF,Freiburg,20,2000,0.2,0,0,0,0,0,0,1,0.0,1,0,0,0,0,0,0,0,Matches
Roman Bürki,ch SUI,GK,Dortmund,29,1990,18.5,0,0,0,0,0,0,0,,0,0,0,0,0,0,5,1,Matches
Kerim Calhanoglu,de GER,DF,Schalke 04,17,2002,3.3,3,3,1,1,1,0,3,0.0,3,4,0,4,7,10,6,0,Matches
Daniel Caligiuri,it ITA,"MF,FW",Augsburg,32,1988,29.6,71,46,29,31,11,29,92,31.5,63,45,6,39,38,109,41,0,Matches
Emre Can,de GER,"DF,MF",Dortmund,26,1994,23.7,43,34,20,20,3,20,37,54.1,17,35,10,25,48,91,52,0,Matches
Koen Casteels,be BEL,GK,Wolfsburg,28,1992,32.0,0,0,0,0,0,0,1,0.0,1,1,0,1,2,2,9,2,Matches
Gonzalo Castro,de GER,MF,Stuttgart,33,1987,19.2,21,7,6,9,6,8,23,34.8,15,16,3,13,8,29,12,0,Matches
Sava Cestic,rs SRB,DF,Köln,19,2001,10.0,20,9,12,6,2,8,17,47.1,9,13,4,9,18,38,40,0,Matches
Timothy Chandler,us USA,DF,Eint Frankfurt,30,1990,4.8,4,0,2,1,1,1,4,25.0,3,5,2,3,3,7,5,0,Matches
Kwon Chang-hoon,kr KOR,"MF,FW",Freiburg,26,1994,2.4,3,1,1,0,2,1,3,33.3,2,3,1,2,7,10,2,1,Matches
Tahith Chong,nl NED,"MF,FW",Werder Bremen,20,1999,4.3,11,6,1,9,1,4,8,50.0,4,4,0,4,5,16,1,0,Matches
Darko Churlinov,mk MKD,"DF,MF",Stuttgart,20,2000,2.4,2,2,2,0,0,1,3,33.3,2,5,1,4,0,2,2,0,Matches
Tim Civeja,al ALB,MF,Augsburg,18,2002,0.4,0,0,0,0,0,0,1,0.0,1,0,0,0,3,3,0,0,Matches
Kingsley Coman,fr FRA,"FW,MF",Bayern Munich,24,1996,19.5,14,8,6,7,1,2,21,9.5,19,22,0,22,4,18,3,0,Matches
Jhon Córdoba,co COL,FW,Hertha BSC,27,1993,17.1,9,4,1,5,3,2,4,50.0,2,13,2,11,6,15,4,0,Matches
Sergio Córdova,ve VEN,"FW,MF",Arminia,22,1997,12.1,16,8,0,10,6,2,15,13.3,13,14,3,11,9,25,9,0,Matches
Danny da Costa,de GER,"DF,FW",Mainz 05,27,1993,13.4,22,16,6,9,7,13,27,48.1,14,17,2,15,17,39,27,0,Matches
Danny da Costa,de GER,DF,Eint Frankfurt,27,1993,1.2,0,0,0,0,0,0,1,0.0,1,3,1,2,0,0,4,0,Matches
Douglas Costa,br BRA,"FW,MF",Bayern Munich,29,1990,3.6,2,1,1,1,0,1,3,33.3,2,7,0,7,2,4,1,0,Matches
Tanguy Coulibaly,fr FRA,"DF,FW",Stuttgart,19,2001,16.7,26,15,10,7,9,11,23,47.8,12,20,0,20,10,36,11,0,Matches
Mickaël Cuisance,fr FRA,FW,Bayern Munich,20,1999,0.2,0,0,0,0,0,0,0,,0,1,0,1,0,0,0,0,Matches
Matheus Cunha,br BRA,"FW,MF",Hertha BSC,21,1999,23.9,36,16,10,19,7,13,49,26.5,36,29,2,27,31,67,9,0,Matches
Rafael Czichos,de GER,DF,Köln,30,1990,25.1,48,24,33,13,2,23,42,54.8,19,25,9,16,53,101,109,0,Matches
Moanes Dabbur,il ISR,"FW,MF",Hoffenheim,28,1992,11.1,6,3,3,1,2,1,13,7.7,12,6,0,6,9,15,7,0,Matches
Finn Dahmen,de GER,GK,Mainz 05,22,1998,3.0,0,0,0,0,0,0,1,0.0,1,0,0,0,0,0,1,0,Matches
Mahmoud Dahoud,de GER,MF,Dortmund,24,1996,14.0,30,18,9,20,1,14,38,36.8,24,23,5,18,18,48,11,1,Matches
Leon Dajaku,de GER,FW,Union Berlin,19,2001,0.4,0,0,0,0,0,0,0,,0,0,0,0,0,0,0,0,Matches
Tiago Dantas,pt POR,MF,Bayern Munich,19,2000,0.8,1,1,0,0,1,0,0,,0,0,0,0,0,1,0,0,Matches
Márton Dárdai,de GER,"DF,MF",Hertha BSC,18,2002,9.1,17,10,10,6,1,9,16,56.3,7,7,3,4,16,33,31,0,Matches
Vladimír Darida,cz CZE,MF,Hertha BSC,29,1990,21.1,34,19,11,19,4,9,31,29.0,22,34,2,32,27,61,18,0,Matches
Alphonso Davies,ca CAN,DF,Bayern Munich,19,2000,19.6,39,27,16,17,6,28,40,70.0,12,21,1,20,28,67,33,1,Matches
Thomas Delaney,dk DEN,MF,Dortmund,28,1991,14.3,40,30,15,20,5,11,31,35.5,20,28,10,18,22,62,15,1,Matches
Kerem Demirbay,de GER,MF,Leverkusen,27,1993,19.4,46,31,15,26,5,19,38,50.0,19,21,4,17,8,54,6,1,Matches
Ermedin Demirović,ba BIH,FW,Freiburg,22,1998,16.6,15,9,4,6,5,2,16,12.5,14,29,5,24,0,15,27,0,Matches
Emmanuel Dennis,ng NGA,FW,Köln,22,1997,5.3,13,7,6,5,2,1,6,16.7,5,6,0,6,0,13,0,1,Matches
Mike van der Hoorn,nl NED,DF,Arminia,27,1992,15.1,8,4,3,5,0,1,3,33.3,2,12,8,4,27,35,73,0,Matches
Moussa Diaby,fr FRA,"FW,MF",Leverkusen,21,1999,26.5,10,6,4,5,1,6,20,30.0,14,11,0,11,12,22,5,0,Matches
Daniel Didavi,de GER,"MF,FW",Stuttgart,30,1990,10.8,16,6,2,9,5,7,12,58.3,5,10,0,10,3,19,8,0,Matches
Javairô Dilrosun,nl NED,"FW,MF",Hertha BSC,22,1998,5.9,5,3,2,2,1,1,6,16.7,5,5,0,5,4,9,3,0,Matches
Eren Dinkçi,de GER,"MF,FW",Werder Bremen,18,2001,1.2,1,1,1,0,0,0,1,0.0,1,4,0,4,2,3,1,0,Matches
Jonas Dirkner,de GER,MF,Hertha BSC,18,2002,0.2,0,0,0,0,0,0,0,,0,0,0,0,0,0,0,0,Matches
Ritsu Doan,jp JPN,"MF,FW",Arminia,22,1998,30.8,53,31,22,19,12,19,52,36.5,33,42,1,41,31,84,11,0,Matches
Ji Dong-won,kr KOR,FW,Mainz 05,29,1991,0.7,1,1,1,0,0,0,0,,0,1,0,1,2,3,0,0,Matches
Bas Dost,nl NED,FW,Eint Frankfurt,31,1989,9.1,3,2,1,1,1,2,5,40.0,3,5,1,4,2,5,8,0,Matches
Aleksandar Dragović,at AUT,DF,Leverkusen,29,1991,12.6,11,7,5,5,1,9,13,69.2,4,17,5,12,13,24,33,0,Matches
Dominick Drexler,de GER,"MF,FW",Köln,30,1990,13.7,36,26,15,18,3,12,30,40.0,18,5,1,4,14,50,15,0,Matches
Ondrej Duda,sk SVK,"FW,MF",Köln,25,1994,28.2,36,14,13,18,5,8,39,20.5,31,28,2,26,19,55,20,0,Matches
Erik Durm,de GER,DF,Eint Frankfurt,28,1992,16.4,17,13,7,9,1,8,21,38.1,13,19,5,14,29,46,26,0,Matches
Johannes Eggestein,de GER,"FW,MF",Werder Bremen,22,1998,0.4,0,0,0,0,0,0,1,0.0,1,0,0,0,1,1,2,0,Matches
Maximilian Eggestein,de GER,MF,Werder Bremen,23,1996,32.7,57,42,22,29,6,21,46,45.7,25,30,5,25,43,100,36,0,Matches
Lilian Egloff,de GER,MF,Stuttgart,17,2002,0.2,0,0,0,0,0,0,0,,0,0,0,0,0,0,0,0,Matches
Kingsley Ehizibue,nl NED,DF,Köln,25,1995,12.6,32,19,22,9,1,10,17,58.8,7,19,5,14,18,50,42,0,Matches
Nico Elvedi,ch SUI,DF,M'Gladbach,23,1996,28.2,49,35,36,12,1,25,37,67.6,12,38,22,16,65,114,123,0,Matches
Breel Embolo,ch SUI,"FW,MF",M'Gladbach,23,1997,16.0,15,10,1,13,1,0,6,0.0,6,16,1,15,8,23,8,0,Matches
Keita Endo,jp JPN,"MF,FW",Union Berlin,22,1997,5.1,8,3,1,5,2,3,9,33.3,6,5,2,3,6,14,4,0,Matches
Wataru Endo,jp JPN,MF,Stuttgart,27,1993,32.8,65,44,25,34,6,29,71,40.8,42,53,14,39,51,116,59,0,Matches
Patrick Erras,de GER,"FW,MF",Werder Bremen,25,1995,0.3,0,0,0,0,0,0,1,0.0,1,0,0,0,0,0,0,0,Matches
Ralf Fährmann,de GER,GK,Schalke 04,31,1988,20.8,2,1,2,0,0,1,2,50.0,1,0,0,0,1,3,9,3,Matches
Ohis Felix Uduokhai,de GER,DF,Augsburg,22,1997,29.0,33,24,19,10,4,18,27,66.7,9,48,25,23,54,87,164,2,Matches
Edimilson Fernandes,ch SUI,"MF,FW",Mainz 05,24,1996,9.3,8,4,4,4,0,4,7,57.1,3,12,4,8,29,37,25,0,Matches
Alfreð Finnbogason,is ISL,FW,Augsburg,31,1989,6.0,2,1,0,1,1,0,1,0.0,1,7,1,6,1,3,4,0,Matches
Mark Flekken,nl NED,GK,Freiburg,27,1993,3.0,0,0,0,0,0,0,0,,0,0,0,0,0,0,1,0,Matches
Florian Flick,de GER,MF,Schalke 04,20,2000,4.0,10,7,4,6,0,7,16,43.8,9,4,3,1,7,17,5,1,Matches
Emil Forsberg,se SWE,"FW,MF",RB Leipzig,28,1991,17.1,11,6,1,6,4,5,27,18.5,22,10,1,9,11,22,4,0,Matches
Philipp Förster,de GER,MF,Stuttgart,25,1995,16.8,22,13,7,12,3,6,25,24.0,19,18,1,17,15,37,2,0,Matches
Timothy Fosu-Mensah,nl NED,DF,Leverkusen,22,1998,4.5,4,2,1,2,1,2,4,50.0,2,7,3,4,7,11,4,0,Matches
Raphael Framberger,de GER,DF,Augsburg,24,1995,17.1,42,23,26,11,5,19,25,76.0,6,24,2,22,36,78,62,1,Matches
Marco Friedl,at AUT,DF,Werder Bremen,22,1998,30.9,50,34,31,17,2,30,62,48.4,32,38,17,21,55,105,118,1,Matches
Marvin Friedrich,de GER,DF,Union Berlin,24,1995,34.0,47,29,35,11,1,18,32,56.3,14,38,18,20,52,99,109,0,Matches
Jeremie Frimpong,nl NED,"DF,FW",Leverkusen,19,2000,4.8,7,4,4,3,0,4,8,50.0,4,4,0,4,1,8,7,0,Matches
Niclas Füllkrug,de GER,FW,Werder Bremen,27,1993,9.7,7,3,2,4,1,1,13,7.7,12,10,4,6,3,10,13,0,Matches
Mijat Gaćinović,rs SRB,"DF,MF",Hoffenheim,25,1995,9.1,18,10,6,11,1,9,24,37.5,15,13,0,13,18,36,15,0,Matches
Christian Gebauer,at AUT,"MF,FW",Arminia,26,1993,7.6,9,4,2,5,2,4,11,36.4,7,4,1,3,6,15,14,0,Matches
Theodor Gebre Selassie,cz CZE,DF,Werder Bremen,33,1986,33.7,61,35,39,17,5,28,64,43.8,36,33,11,22,58,119,98,1,Matches
Emrehan Gedikli,de GER,FW,Leverkusen,17,2003,0.3,0,0,0,0,0,0,0,,0,0,0,0,0,0,0,0,Matches
Dennis Geiger,de GER,MF,Hoffenheim,22,1998,7.3,13,10,3,8,2,5,8,62.5,3,10,0,10,3,16,0,0,Matches
Christian Gentner,de GER,MF,Union Berlin,34,1985,11.5,17,8,9,5,3,5,18,27.8,13,13,1,12,17,34,16,0,Matches
Yannick Gerhardt,de GER,"MF,FW",Wolfsburg,26,1994,21.5,52,32,14,32,6,21,52,40.4,31,34,4,30,21,73,30,0,Matches
Hamadi Al Ghaddioui,ma MAR,FW,Stuttgart,29,1990,0.5,0,0,0,0,0,0,1,0.0,1,0,0,0,0,0,0,0,Matches
Niko Gießelmann,de GER,DF,Union Berlin,28,1991,4.8,12,9,7,4,1,5,8,62.5,3,9,3,6,8,20,13,1,Matches
Rafał Gikiewicz,pl POL,GK,Augsburg,32,1987,34.0,0,0,0,0,0,0,3,0.0,3,0,0,0,3,3,9,1,Matches
Daniel Ginczek,de GER,"FW,MF",Wolfsburg,29,1991,2.4,2,2,1,1,0,2,8,25.0,6,2,0,2,1,3,2,0,Matches
Matthias Ginter,de GER,DF,M'Gladbach,26,1994,34.0,26,16,15,10,1,14,24,58.3,10,43,32,11,51,77,121,0,Matches
Robert Glatzel,de GER,FW,Mainz 05,26,1994,4.0,1,0,1,0,0,0,2,0.0,2,2,0,2,0,1,2,0,Matches
Serge Gnabry,de GER,"FW,MF",Bayern Munich,25,1995,18.3,39,19,7,19,13,12,32,37.5,20,17,0,17,26,65,3,0,Matches
Akaki Gogia,de GER,"FW,MF",Union Berlin,28,1992,1.6,1,0,0,1,0,0,2,0.0,2,0,0,0,1,2,0,0,Matches
Nicolás González,ar ARG,"FW,MF",Stuttgart,22,1998,10.4,5,5,1,2,2,0,6,0.0,6,10,3,7,4,9,6,0,Matches
Leon Goretzka,de GER,MF,Bayern Munich,25,1995,18.9,37,23,12,21,4,16,39,41.0,23,30,2,28,44,81,11,0,Matches
Jeffrey Gouweleeuw,nl NED,DF,Augsburg,29,1991,31.5,36,20,24,11,1,16,33,48.5,17,37,18,19,69,105,149,2,Matches
Demarai Gray,jm JAM,FW,Leverkusen,24,1996,4.9,3,2,1,2,0,1,1,100.0,0,3,0,3,4,7,3,0,Matches
Michael Gregoritsch,at AUT,"FW,MF",Augsburg,26,1994,9.3,13,10,6,7,0,3,10,30.0,7,2,0,2,3,16,17,0,Matches
Sebastian Griesbeck,de GER,MF,Union Berlin,29,1990,9.9,20,9,8,11,1,8,19,42.1,11,13,3,10,5,25,8,0,Matches
Vincenzo Grifo,it ITA,"MF,FW",Freiburg,27,1993,25.7,18,7,6,7,5,14,34,41.2,20,13,0,13,27,45,18,1,Matches
Lennart Grill,de GER,GK,Leverkusen,21,1999,4.0,0,0,0,0,0,0,0,,0,0,0,0,0,0,2,0,Matches
Florian Grillitsch,at AUT,"MF,DF",Hoffenheim,24,1995,20.9,37,21,21,13,3,19,52,36.5,33,38,7,31,51,88,47,1,Matches
Christian Groß,de GER,"MF,DF",Werder Bremen,31,1989,16.3,44,28,17,25,2,15,37,40.5,22,12,2,10,24,68,37,0,Matches
Ilia Gruev,bg BUL,FW,Werder Bremen,20,2000,0.0,0,0,0,0,0,0,0,,0,0,0,0,0,0,0,0,Matches
Carlos Gruezo,ec ECU,MF,Augsburg,25,1995,23.2,57,32,20,32,5,20,52,38.5,32,32,5,27,35,92,29,1,Matches
Mattéo Guendouzi,fr FRA,MF,Hertha BSC,21,1999,20.2,24,13,10,12,2,9,25,36.0,16,15,4,11,21,45,24,1,Matches
Raphaël Guerreiro,pt POR,DF,Dortmund,26,1993,24.6,30,13,14,8,8,16,31,51.6,15,21,4,17,28,58,31,1,Matches
Josuha Guilavogui,fr FRA,"MF,DF",Wolfsburg,29,1990,8.3,17,9,9,8,0,5,12,41.7,7,12,5,7,29,46,25,0,Matches
Péter Gulácsi,hu HUN,GK,RB Leipzig,30,1990,33.0,1,0,1,0,0,1,2,50.0,1,0,0,0,2,3,7,0,Matches
Manuel Gulde,de GER,DF,Freiburg,29,1991,21.7,27,15,12,12,3,5,21,23.8,16,25,15,10,37,64,64,0,Matches
Robert Gumny,pl POL,DF,Augsburg,22,1998,15.3,24,15,12,9,3,15,23,65.2,8,12,2,10,18,42,31,0,Matches
Christian Günter,de GER,"DF,MF",Freiburg,27,1993,34.0,34,19,18,13,3,15,43,34.9,28,38,9,29,29,63,40,0,Matches
Erling Haaland,no NOR,FW,Dortmund,20,2000,26.7,7,2,1,3,3,1,4,25.0,3,19,4,15,4,11,16,0,Matches
Janik Haberer,de GER,"MF,FW",Freiburg,26,1994,5.4,7,4,4,3,0,3,15,20.0,12,4,1,3,7,14,9,0,Matches
Alexander Hack,de GER,DF,Mainz 05,26,1993,15.2,32,21,23,8,1,18,31,58.1,13,26,17,9,41,73,91,2,Matches
André Hahn,de GER,"FW,MF",Augsburg,29,1990,22.6,31,17,14,13,4,9,44,20.5,35,35,3,32,14,45,24,0,Matches
Amadou Haidara,ml MLI,"MF,FW",RB Leipzig,22,1998,21.2,50,28,20,21,9,11,36,30.6,25,33,1,32,30,80,24,0,Matches
Marcel Halstenberg,de GER,DF,RB Leipzig,28,1991,18.3,29,18,20,8,1,19,41,46.3,22,15,3,12,16,45,35,0,Matches
Amine Harit,ma MAR,"MF,FW",Schalke 04,23,1997,23.3,22,13,8,11,3,10,23,43.5,13,9,1,8,17,39,7,1,Matches
Marcel Hartel,de GER,MF,Arminia,24,1996,18.7,35,19,15,18,2,20,40,50.0,20,17,4,13,26,61,16,1,Matches
Makoto Hasebe,jp JPN,"DF,MF",Eint Frankfurt,36,1984,25.4,43,29,21,20,2,25,51,49.0,26,31,12,19,31,74,68,2,Matches
Thorgan Hazard,be BEL,"MF,FW",Dortmund,27,1993,7.3,8,2,6,1,1,3,13,23.1,10,4,0,4,10,18,1,0,Matches
Jonas Hector,de GER,"MF,FW",Köln,30,1990,14.3,34,22,8,21,5,15,35,42.9,20,24,5,19,19,53,20,1,Matches
Hwang Hee-chan,kr KOR,"FW,MF",RB Leipzig,24,1996,5.1,3,2,1,0,2,1,7,14.3,6,4,0,4,1,4,1,0,Matches
Dominique Heintz,de GER,DF,Freiburg,26,1993,15.2,22,11,19,3,0,10,19,52.6,9,10,8,2,35,57,49,0,Matches
Benjamin Henrichs,de GER,"DF,MF",RB Leipzig,23,1997,6.0,12,7,4,5,3,2,9,22.2,7,9,1,8,8,20,8,0,Matches
Lucas Hernández,fr FRA,DF,Bayern Munich,24,1996,17.7,41,31,16,17,8,17,31,54.8,14,24,6,18,19,60,38,0,Matches
Patrick Herrmann,de GER,"FW,MF",M'Gladbach,29,1991,9.7,9,6,4,3,2,2,14,14.3,12,16,0,16,10,19,8,0,Matches
Martin Hinteregger,at AUT,DF,Eint Frankfurt,27,1992,28.1,77,49,53,22,2,37,63,58.7,26,31,12,19,44,121,92,0,Matches
Marwin Hitz,ch SUI,GK,Dortmund,32,1987,15.5,1,1,1,0,0,1,1,100.0,0,0,0,0,0,1,7,1,Matches
Nicolas Höfler,de GER,MF,Freiburg,30,1990,30.3,54,28,16,31,7,23,59,39.0,36,34,10,24,66,120,41,2,Matches
Jonas Hofmann,de GER,"FW,MF",M'Gladbach,28,1992,20.2,26,20,12,12,2,10,53,18.9,43,27,2,25,27,53,9,0,Matches
Marco Höger,de GER,"DF,MF",Köln,30,1989,0.6,1,0,0,1,0,1,2,50.0,1,2,0,2,2,3,1,0,Matches
Lucas Höler,de GER,"FW,MF",Freiburg,26,1994,23.2,36,24,13,19,4,12,32,37.5,20,19,2,17,16,52,14,0,Matches
Matthew Hoppe,us USA,FW,Schalke 04,19,2001,14.5,6,6,1,3,2,2,12,16.7,10,8,2,6,4,10,15,0,Matches
Jannes Horn,de GER,DF,Köln,23,1997,19.6,35,19,23,11,1,23,31,74.2,8,19,2,17,10,45,45,0,Matches
Timo Horn,de GER,GK,Köln,27,1993,33.4,1,0,1,0,0,1,4,25.0,3,1,0,1,0,1,11,2,Matches
Lukáš Hrádecký,fi FIN,GK,Leverkusen,30,1989,28.5,0,0,0,0,0,0,1,0.0,1,0,0,0,1,1,11,3,Matches
Ajdin Hrustic,au AUS,"MF,DF",Eint Frankfurt,24,1996,3.0,6,5,2,3,1,3,10,30.0,7,2,0,2,4,10,3,0,Matches
Florian Hübner,de GER,DF,Union Berlin,29,1991,5.8,10,5,7,3,0,7,15,46.7,8,7,3,4,13,23,21,0,Matches
Mats Hummels,de GER,DF,Dortmund,31,1988,31.3,58,40,34,18,6,26,42,61.9,16,31,22,9,73,131,122,2,Matches
Klaas-Jan Huntelaar,nl NED,FW,Schalke 04,36,1983,6.5,4,2,0,2,2,0,2,0.0,2,3,1,2,2,6,3,0,Matches
Iago,br BRA,DF,Augsburg,23,1997,17.3,37,27,21,13,3,17,29,58.6,12,17,5,12,22,59,55,0,Matches
Vedad Ibišević,ba BIH,FW,Schalke 04,35,1984,1.7,0,0,0,0,0,0,0,,0,1,0,1,1,1,1,0,Matches
Blendi Idrizi,xk KVX,MF,Schalke 04,22,1998,2.6,8,4,1,6,1,1,1,100.0,0,6,2,4,3,11,1,0,Matches
Stefan Ilsanker,at AUT,"MF,DF",Eint Frankfurt,31,1989,17.5,33,20,17,15,1,21,42,50.0,21,30,8,22,30,63,51,2,Matches
Marcus Ingvartsen,dk DEN,"MF,FW",Union Berlin,24,1996,21.8,17,11,5,6,6,8,26,30.8,18,22,0,22,18,35,10,0,Matches
Ismail Jakobs,sn SEN,"MF,FW",Köln,20,1999,19.2,25,10,17,4,4,11,21,52.4,10,18,1,17,16,41,36,0,Matches
Tony Jantschke,de GER,DF,M'Gladbach,30,1990,3.0,2,2,1,1,0,1,3,33.3,2,6,4,2,4,6,7,0,Matches
Rune Jarstein,no NOR,GK,Hertha BSC,35,1984,8.0,0,0,0,0,0,0,0,,0,0,0,0,0,0,7,1,Matches
Tin Jedvaj,hr CRO,DF,Leverkusen,24,1995,1.7,5,2,2,3,0,1,3,33.3,2,2,1,1,2,7,9,0,Matches
Fredrik Jensen,fi FIN,"FW,MF",Augsburg,22,1997,4.2,3,2,1,2,0,3,6,50.0,3,4,1,3,2,5,6,0,Matches
Marco John,de GER,DF,Hoffenheim,18,2002,11.1,21,15,9,5,7,10,22,45.5,12,18,1,17,16,37,21,0,Matches
Luka Jović,rs SRB,FW,Eint Frankfurt,22,1997,9.9,2,0,0,2,0,0,4,0.0,4,3,0,3,1,3,7,0,Matches
Ozan Kabak,tr TUR,DF,Schalke 04,20,2000,13.8,17,9,11,5,1,6,13,46.2,7,20,11,9,13,30,57,0,Matches
Pavel Kadeřábek,cz CZE,"DF,FW",Hoffenheim,28,1992,17.6,15,12,7,6,2,6,15,40.0,9,12,3,9,18,33,31,0,Matches
Florian Kainz,at AUT,"MF,FW",Köln,27,1992,5.0,4,2,0,4,0,2,8,25.0,6,7,0,7,3,7,3,0,Matches
Sasa Kalajdzic,at AUT,FW,Stuttgart,23,1997,23.7,16,12,4,5,7,2,17,11.8,15,10,1,9,9,25,21,0,Matches
Daichi Kamada,jp JPN,MF,Eint Frankfurt,23,1996,26.2,48,28,21,16,11,16,49,32.7,33,18,1,17,14,62,22,0,Matches
Marcin Kamiński,pl POL,DF,Stuttgart,28,1992,2.4,1,1,0,0,1,0,0,,0,2,1,1,1,2,10,0,Matches
Kevin Kampl,si SVN,MF,RB Leipzig,29,1990,21.5,38,26,9,24,5,18,35,51.4,17,20,2,18,29,67,14,0,Matches
Jimmy Kaparos,de GER,MF,Schalke 04,18,2001,0.2,0,0,0,0,0,0,1,0.0,1,0,0,0,0,0,0,0,Matches
Atakan Karazor,de GER,"DF,MF",Stuttgart,23,1996,11.5,20,12,12,7,1,13,22,59.1,9,18,8,10,21,41,50,2,Matches
Loris Karius,de GER,GK,Union Berlin,27,1993,3.2,0,0,0,0,0,0,0,,0,0,0,0,0,0,2,0,Matches
Silas Katompa,cd COD,"DF,FW",Stuttgart,21,1998,21.3,48,29,19,19,10,21,44,47.7,23,29,1,28,22,70,11,2,Matches
Noah Katterbach,de GER,"DF,MF",Köln,19,2001,12.3,18,11,11,6,1,13,21,61.9,8,7,3,4,23,41,22,0,Matches
Yannik Keitel,de GER,MF,Freiburg,20,2000,5.5,12,8,7,4,1,7,9,77.8,2,9,3,6,10,22,8,0,Matches
Marc-Oliver Kempf,de GER,DF,Stuttgart,25,1995,30.3,49,26,28,18,3,29,49,59.2,20,40,25,15,68,117,103,1,Matches
Rani Khedira,de GER,MF,Augsburg,26,1994,20.2,29,10,13,15,1,10,20,50.0,10,14,5,9,31,60,47,0,Matches
Sami Khedira,de GER,MF,Hertha BSC,33,1987,4.4,11,6,3,7,1,6,12,50.0,6,4,0,4,9,20,7,0,Matches
Luca Kilian,de GER,DF,Mainz 05,20,1999,4.2,14,7,10,4,0,9,17,52.9,8,3,1,2,13,27,12,0,Matches
Joshua Kimmich,de GER,MF,Bayern Munich,25,1995,24.4,40,28,16,19,5,10,53,18.9,43,25,5,20,36,76,19,0,Matches
Davy Klaassen,nl NED,MF,Werder Bremen,27,1993,2.5,3,1,0,1,2,0,5,0.0,5,5,1,4,3,6,4,0,Matches
Felix Klaus,de GER,"DF,MF",Wolfsburg,27,1992,1.5,7,4,3,4,0,4,5,80.0,1,4,0,4,2,9,4,0,Matches
Klauss,br BRA,"MF,FW",Hoffenheim,23,1997,0.6,1,0,0,0,1,0,1,0.0,1,0,0,0,0,1,0,0,Matches
Philipp Klement,de GER,"MF,FW",Stuttgart,27,1992,4.7,7,3,6,0,1,3,7,42.9,4,9,2,7,6,13,7,0,Matches
Mateo Klimowicz,de GER,"MF,FW",Stuttgart,20,2000,13.3,20,15,6,10,4,5,18,27.8,13,5,1,4,2,22,2,0,Matches
Fabian Klos,de GER,FW,Arminia,32,1987,30.1,24,13,9,11,4,7,26,26.9,19,20,6,14,4,28,29,0,Matches
Lukas Klostermann,de GER,DF,RB Leipzig,24,1996,16.1,23,19,8,12,3,11,18,61.1,7,16,6,10,18,41,44,1,Matches
Justin Kluivert,nl NED,"FW,MF",RB Leipzig,21,1999,9.0,2,1,1,1,0,0,2,0.0,2,4,0,4,5,7,3,0,Matches
Lukas Klünter,de GER,DF,Hertha BSC,24,1996,11.0,10,5,6,4,0,5,10,50.0,5,3,1,2,11,21,29,1,Matches
Ansgar Knauff,de GER,"MF,FW",Dortmund,18,2002,0.8,0,0,0,0,0,0,1,0.0,1,3,1,2,0,0,0,0,Matches
Robin Knoche,de GER,DF,Union Berlin,28,1992,33.8,44,29,30,12,2,23,39,59.0,16,43,27,16,49,93,118,2,Matches
Gregor Kobel,ch SUI,GK,Stuttgart,22,1997,33.0,2,2,2,0,0,2,2,100.0,0,0,0,0,2,4,8,1,Matches
Dominik Kohr,de GER,MF,Mainz 05,26,1994,14.1,47,31,14,26,7,20,39,51.3,19,18,5,13,27,74,15,0,Matches
Dominik Kohr,de GER,"MF,DF",Eint Frankfurt,26,1994,2.9,11,7,0,7,4,4,9,44.4,5,5,1,4,9,20,9,0,Matches
Sead Kolašinac,ba BIH,"DF,MF",Schalke 04,27,1993,15.8,20,17,10,7,3,8,18,44.4,10,17,5,12,20,40,17,0,Matches
Ibrahima Konaté,fr FRA,DF,RB Leipzig,21,1999,7.7,6,4,2,3,1,2,8,25.0,6,6,3,3,8,14,24,0,Matches
Filip Kostić,rs SRB,DF,Eint Frankfurt,27,1992,28.2,54,31,22,23,9,22,54,40.7,32,43,6,37,26,80,28,2,Matches
Andrej Kramarić,hr CRO,"FW,MF",Hoffenheim,29,1991,26.4,7,4,4,0,3,3,8,37.5,5,8,1,7,7,14,5,1,Matches
Christoph Kramer,de GER,MF,M'Gladbach,29,1991,22.6,55,37,22,28,5,28,58,48.3,30,32,11,21,34,89,39,0,Matches
Max Kruse,de GER,"FW,MF",Union Berlin,32,1988,18.1,7,3,1,5,1,2,9,22.2,7,11,0,11,3,10,3,0,Matches
Lukas Kübler,de GER,"DF,MF",Freiburg,27,1992,9.8,15,8,9,5,1,9,14,64.3,5,9,3,6,21,36,31,0,Matches
Pierre Kunde,cm CMR,MF,Mainz 05,25,1995,5.7,8,4,1,5,2,2,9,22.2,7,6,0,6,10,18,9,0,Matches
Fabian Kunze,de GER,MF,Arminia,22,1998,14.1,38,26,19,15,4,19,42,45.2,23,19,3,16,18,56,22,1,Matches
Ahmed Kutucu,tr TUR,"FW,MF",Schalke 04,20,2000,1.2,1,0,0,0,1,1,2,50.0,1,1,0,1,0,1,0,0,Matches
Maxence Lacroix,fr FRA,DF,Wolfsburg,20,2000,28.8,49,29,37,12,0,24,45,53.3,21,51,21,30,65,114,140,1,Matches
Konrad Laimer,at AUT,"DF,MF",RB Leipzig,23,1997,0.9,2,0,0,1,1,0,4,0.0,4,2,0,2,1,3,0,0,Matches
Stefan Lainer,at AUT,DF,M'Gladbach,27,1992,30.8,62,37,30,22,10,27,60,45.0,33,34,5,29,35,97,85,1,Matches
Michael Langer,at AUT,GK,Schalke 04,35,1985,2.7,0,0,0,0,0,0,0,,0,0,0,0,0,0,3,0,Matches
Danny Latza,de GER,MF,Mainz 05,30,1989,20.0,43,26,12,19,12,23,70,32.9,47,39,3,36,27,70,23,0,Matches
Valentino Lazaro,at AUT,"DF,FW",M'Gladbach,24,1996,13.8,17,11,7,5,5,12,19,63.2,7,18,1,17,15,32,20,0,Matches
Mathew Leckie,au AUS,"FW,DF",Hertha BSC,29,1991,5.6,12,3,5,5,2,4,11,36.4,7,8,0,8,13,25,9,0,Matches
Christopher Lenz,de GER,"DF,FW",Union Berlin,25,1994,25.0,74,41,39,30,5,35,71,49.3,36,34,5,29,35,109,50,0,Matches
Robert Lewandowski,pl POL,FW,Bayern Munich,31,1988,27.3,15,9,0,7,8,2,13,15.4,11,9,1,8,3,18,11,0,Matches
Philipp Lienhart,at AUT,DF,Freiburg,24,1996,33.3,21,13,12,7,2,9,20,45.0,11,30,21,9,42,63,100,0,Matches
Dimitris Limnios,gr GRE,"MF,FW",Köln,22,1998,4.2,9,6,3,5,1,5,6,83.3,1,5,0,5,2,11,1,0,Matches
Niklas Lomb,de GER,GK,Leverkusen,27,1993,1.5,0,0,0,0,0,0,0,,0,0,0,0,0,0,0,2,Matches
Eduard Löwen,de GER,"MF,DF",Hertha BSC,23,1997,0.9,5,1,3,1,1,2,5,40.0,3,1,0,1,1,6,1,0,Matches
Jan Luca Schuler,de GER,FW,Schalke 04,21,1999,0.4,2,2,1,1,0,0,1,0.0,1,1,0,1,0,2,0,0,Matches
Anderson Lucoqui,ao ANG,DF,Arminia,23,1997,17.8,40,25,23,17,0,20,40,50.0,20,30,7,23,27,67,53,0,Matches
Kilian Ludewig,de GER,"DF,FW",Schalke 04,20,2000,5.8,16,6,10,5,1,8,25,32.0,17,7,0,7,3,19,14,0,Matches
Dodi Lukebakio,be BEL,"FW,MF",Hertha BSC,22,1997,20.6,21,14,13,5,3,9,20,45.0,11,14,1,13,12,33,8,0,Matches
Andreas Luthe,de GER,GK,Union Berlin,33,1987,30.8,1,1,1,0,0,1,3,33.3,2,1,0,1,0,1,8,3,Matches
Tim Maciejewski,de GER,FW,Union Berlin,19,2001,0.1,0,0,0,0,0,0,0,,0,0,0,0,0,0,0,0,Matches
Luca Mack,de GER,MF,Stuttgart,20,2000,0.1,0,0,0,0,0,0,0,,0,0,0,0,0,0,1,0,Matches
Mikail Maden,no NOR,FW,Schalke 04,18,2002,0.1,0,0,0,0,0,0,0,,0,0,0,0,0,0,0,0,Matches
Arne Maier,de GER,MF,Arminia,21,1999,11.5,13,9,5,7,1,4,11,36.4,7,10,3,7,8,21,11,1,Matches
Arne Maier,de GER,MF,Hertha BSC,21,1999,0.3,1,1,0,1,0,0,1,0.0,1,0,0,0,0,1,0,0,Matches
Yunus Mallı,tr TUR,MF,Wolfsburg,28,1992,0.6,1,0,0,1,0,1,1,100.0,0,0,0,0,0,1,0,0,Matches
Orel Mangala,be BEL,MF,Stuttgart,22,1998,23.4,27,15,13,11,3,17,28,60.7,11,27,10,17,26,53,30,0,Matches
Omar Marmoush,eg EGY,FW,Wolfsburg,21,1999,0.0,0,0,0,0,0,0,0,,0,0,0,0,0,0,0,0,Matches
Aarón Martín,es ESP,"DF,FW",Mainz 05,23,1997,2.9,3,2,2,1,0,2,4,50.0,2,1,0,1,2,5,2,0,Matches
Javi Martínez,es ESP,"DF,MF",Bayern Munich,31,1988,5.2,10,5,4,4,2,7,9,77.8,2,8,4,4,13,23,19,0,Matches
Josep Martinez,es ESP,GK,RB Leipzig,22,1998,1.0,0,0,0,0,0,0,0,,0,0,0,0,0,0,0,0,Matches
Omar Mascarell,es ESP,MF,Schalke 04,27,1993,19.6,41,24,15,19,7,21,54,38.9,33,40,14,26,37,78,32,1,Matches
Roberto Massimo,de GER,"DF,FW",Stuttgart,19,2000,8.4,21,11,13,5,3,11,24,45.8,13,5,1,4,11,32,13,0,Matches
Jean-Philippe Mateta,fr FRA,FW,Mainz 05,23,1997,11.1,6,3,1,3,2,0,3,0.0,3,3,1,2,4,10,6,0,Matches
Rabbi Matondo,wls WAL,"FW,MF",Schalke 04,19,2000,2.4,3,2,0,3,0,2,3,66.7,1,1,0,1,1,4,1,0,Matches
Henning Matriciani,de GER,DF,Schalke 04,20,2000,0.3,1,1,1,0,0,1,1,100.0,0,1,0,1,0,1,1,0,Matches
Konstantinos Mavropanos,gr GRE,DF,Stuttgart,22,1997,16.3,42,29,29,12,1,27,46,58.7,19,25,10,15,59,101,66,1,Matches
Eric Maxim Choupo-Moting,cm CMR,"FW,MF",Bayern Munich,31,1989,9.1,8,2,0,5,3,1,4,25.0,3,6,0,6,2,10,7,0,Matches
Kevin Mbabu,ch SUI,DF,Wolfsburg,25,1995,18.2,51,33,27,17,7,24,35,68.6,11,28,7,21,22,73,59,1,Matches
Jean-Manuel Mbom,de GER,"MF,DF",Werder Bremen,20,2000,12.9,19,13,14,3,2,8,27,29.6,19,17,6,11,13,32,27,0,Matches
Nathan de Medina,be BEL,DF,Arminia,22,1997,7.1,16,10,9,6,1,3,10,30.0,7,12,2,10,11,27,22,0,Matches
Joshua Mees,de GER,FW,Union Berlin,24,1996,0.1,0,0,0,0,0,0,0,,0,0,0,0,0,0,0,0,Matches
Admir Mehmedi,ch SUI,"MF,FW",Wolfsburg,29,1991,9.1,17,9,6,7,4,6,16,37.5,10,7,0,7,5,22,1,0,Matches
Hamza Mendyl,ma MAR,"FW,DF",Schalke 04,22,1997,1.1,2,2,2,0,0,0,2,0.0,2,2,0,2,0,2,2,0,Matches
Levent Mercan,de GER,FW,Schalke 04,19,2000,0.1,0,0,0,0,0,0,0,,0,0,0,0,0,0,0,0,Matches
Jorge Meré,es ESP,DF,Köln,23,1997,14.4,13,6,9,3,1,6,13,46.2,7,14,11,3,15,28,63,0,Matches
Thomas Meunier,be BEL,DF,Dortmund,28,1991,16.4,30,21,19,6,5,20,29,69.0,9,16,6,10,18,48,29,2,Matches
Max Meyer,de GER,MF,Köln,24,1995,3.9,7,4,3,3,1,4,8,50.0,4,4,1,3,3,10,1,0,Matches
Jonas Michelbrink,de GER,MF,Hertha BSC,19,2001,0.4,0,0,0,0,0,0,0,,0,0,0,0,0,0,0,0,Matches
Maximilian Mittelstädt,de GER,"DF,FW",Hertha BSC,23,1997,20.0,66,39,42,21,3,35,72,48.6,37,34,5,29,55,121,61,1,Matches
Anthony Modeste,fr FRA,FW,Köln,32,1988,2.5,2,0,0,2,0,0,1,0.0,1,0,0,0,0,2,2,0,Matches
Kevin Möhwald,de GER,MF,Werder Bremen,27,1993,17.3,15,9,9,5,1,4,18,22.2,14,10,3,7,32,47,19,2,Matches
Niklas Moisander,fi FIN,DF,Werder Bremen,34,1985,13.6,14,11,11,3,0,8,14,57.1,6,15,8,7,22,36,61,0,Matches
Alkhaly Momo Cissé,gn GUI,"FW,DF",Stuttgart,17,2002,0.4,1,1,1,0,0,0,0,,0,1,0,1,0,1,0,0,Matches
Jan Morávek,cz CZE,MF,Augsburg,30,1989,3.0,5,3,4,1,0,1,8,12.5,7,3,0,3,7,12,2,0,Matches
Mateu Morey,es ESP,,Dortmund,20,2000,9.2,,8,,,,,,,,,,,16,,,,Matches
Youssoufa Moukoko,de GER,"FW,MF",Dortmund,15,2004,4.7,3,2,1,1,1,0,0,,0,3,0,3,0,3,2,0,Matches
Nordi Mukiele,fr FRA,DF,RB Leipzig,22,1997,18.6,44,30,14,28,2,21,37,56.8,16,33,1,32,23,67,33,2,Matches
Florian Müller,de GER,GK,Freiburg,22,1997,31.0,0,0,0,0,0,0,3,0.0,3,1,0,1,2,2,10,1,Matches
Sebastian Müller,de GER,"MF,DF",Arminia,19,2001,0.0,0,0,0,0,0,0,0,,0,0,0,0,0,0,0,0,Matches
Thomas Müller,de GER,MF,Bayern Munich,30,1989,29.7,49,22,11,23,15,24,73,32.9,49,43,3,40,21,70,18,1,Matches
Petar Musa,hr CRO,FW,Union Berlin,22,1998,7.9,12,8,3,6,3,4,8,50.0,4,10,0,10,4,16,5,0,Matches
Jamal Musiala,de GER,"FW,MF",Bayern Munich,17,2003,9.8,20,12,5,7,8,7,22,31.8,15,17,2,15,14,34,3,0,Matches
Shkodran Mustafi,de GER,DF,Schalke 04,28,1992,11.5,16,5,15,1,0,3,12,25.0,9,20,15,5,32,48,76,1,Matches
Phillipp Mwene,at AUT,"DF,MF",Mainz 05,26,1994,18.6,36,23,21,11,4,19,38,50.0,19,26,3,23,24,60,33,0,Matches
Obite N'Dicka,ci CIV,DF,Eint Frankfurt,20,1999,22.7,31,23,16,15,0,16,28,57.1,12,27,6,21,47,78,85,0,Matches
Matija Nastasić,rs SRB,DF,Schalke 04,27,1993,13.6,11,7,9,2,0,9,16,56.3,7,22,18,4,26,37,51,1,Matches
Paul Nebel,de GER,"MF,FW",Mainz 05,17,2002,0.6,1,1,0,1,0,0,1,0.0,1,0,0,0,2,3,0,0,Matches
Luca Netz,de GER,"DF,FW",Hertha BSC,17,2003,3.4,14,8,12,2,0,6,17,35.3,11,3,0,3,6,20,8,0,Matches
Manuel Neuer,de GER,GK,Bayern Munich,34,1986,33.0,0,0,0,0,0,0,1,0.0,1,0,0,0,2,2,12,3,Matches
Florian Neuhaus,de GER,MF,M'Gladbach,23,1997,29.1,48,28,19,26,3,19,63,30.2,44,35,7,28,50,98,20,1,Matches
Jessic Ngankam,de GER,FW,Hertha BSC,20,2000,3.3,5,2,1,2,2,1,3,33.3,2,6,1,5,0,5,1,0,Matches
Moussa Niakhate,sn SEN,DF,Mainz 05,24,1996,31.8,42,22,28,13,1,14,29,48.3,15,31,15,16,49,91,79,0,Matches
Tanguy Nianzou,fr FRA,"DF,FW",Bayern Munich,18,2002,1.3,3,1,3,0,0,1,1,100.0,0,0,0,0,3,6,1,0,Matches
Florian Niederlechner,de GER,FW,Augsburg,29,1990,19.3,7,5,1,4,2,0,10,0.0,10,8,3,5,10,17,18,0,Matches
Joakim Nilsson,se SWE,DF,Arminia,26,1994,24.0,36,24,23,12,1,14,23,60.9,9,29,22,7,39,75,111,0,Matches
Christopher Nkunku,fr FRA,"FW,MF",RB Leipzig,22,1997,21.0,16,11,3,7,6,8,18,44.4,10,27,1,26,9,25,14,0,Matches
Håvard Nordtveit,no NOR,DF,Hoffenheim,30,1990,7.8,6,2,5,1,0,6,8,75.0,2,4,2,2,13,19,42,0,Matches
Alexander Nübel,de GER,GK,Bayern Munich,23,1996,1.0,0,0,0,0,0,0,0,,0,0,0,0,0,0,1,0,Matches
Kasim Nuhu,gh GHA,DF,Hoffenheim,25,1995,11.0,13,7,9,4,0,6,10,60.0,4,8,3,5,15,28,38,0,Matches
Bastian Oczipka,de GER,"DF,FW",Schalke 04,31,1989,21.4,33,20,22,10,1,7,21,33.3,14,22,4,18,24,57,41,0,Matches
Masaya Okugawa,jp JPN,MF,Arminia,24,1996,10.2,17,8,5,11,1,6,14,42.9,8,17,2,15,8,25,5,0,Matches
Dani Olmo,es ESP,MF,RB Leipzig,22,1998,24.4,23,14,6,13,4,4,23,17.4,19,15,0,15,13,36,21,0,Matches
Karim Onisiwo,at AUT,"FW,MF",Mainz 05,28,1992,20.5,31,20,7,15,9,14,23,60.9,9,20,1,19,5,36,12,0,Matches
Willi Orban,hu HUN,DF,RB Leipzig,27,1992,26.3,40,26,19,15,6,23,37,62.2,14,29,20,9,40,80,74,0,Matches
Stefan Ortega,de GER,GK,Arminia,27,1992,34.0,2,1,2,0,0,2,6,33.3,4,0,0,0,0,2,12,3,Matches
Yuya Osako,jp JPN,"MF,FW",Werder Bremen,30,1990,8.5,12,8,2,5,5,2,9,22.2,7,6,1,5,5,17,7,0,Matches
Paulo Otávio,br BRA,DF,Wolfsburg,25,1994,19.3,60,40,32,22,6,34,62,54.8,28,51,7,44,42,102,59,0,Matches
Reece Oxford,eng ENG,DF,Augsburg,21,1998,15.1,26,18,15,11,0,10,17,58.8,7,28,22,6,29,55,89,0,Matches
Salih Özcan,tr TUR,MF,Köln,22,1998,15.2,21,13,11,10,0,12,33,36.4,21,11,2,9,20,41,14,1,Matches
Levin Öztunalı,de GER,"DF,FW",Mainz 05,24,1996,8.4,24,18,14,8,2,8,17,47.1,9,15,0,15,15,39,16,0,Matches
Gonçalo Paciência,pt POR,FW,Schalke 04,25,1994,8.3,8,3,4,1,3,4,16,25.0,12,4,1,3,1,9,3,0,Matches
Exequiel Palacios,ar ARG,MF,Leverkusen,21,1998,6.4,31,17,12,16,3,17,30,56.7,13,13,0,13,12,43,7,0,Matches
Matondo-Merveille Papela,de GER,DF,Mainz 05,19,2001,0.0,0,0,0,0,0,0,1,0.0,1,0,0,0,0,0,0,0,Matches
Felix Passlack,de GER,DF,Dortmund,22,1998,4.0,9,6,4,2,3,4,8,50.0,4,11,1,10,3,12,2,0,Matches
Paulinho,br BRA,FW,Leverkusen,20,2000,0.7,0,0,0,0,0,0,0,,0,0,0,0,0,0,0,0,Matches
Benjamin Pavard,fr FRA,DF,Bayern Munich,24,1996,21.6,44,27,20,16,8,23,40,57.5,17,29,5,24,48,92,31,1,Matches
Jiří Pavlenka,cz CZE,GK,Werder Bremen,28,1992,34.0,2,0,2,0,0,2,2,100.0,0,0,0,0,1,3,17,4,Matches
Vasileios Pavlidis,gr GRE,FW,Schalke 04,17,2002,0.0,0,0,0,0,0,0,0,,0,0,0,0,0,0,0,0,Matches
Mads Pedersen,dk DEN,DF,Augsburg,23,1996,9.9,25,16,20,3,2,10,22,45.5,12,13,3,10,15,40,32,0,Matches
Peter Pekarík,sk SVK,DF,Hertha BSC,33,1986,18.8,24,18,17,7,0,17,31,54.8,14,19,8,11,27,51,41,0,Matches
Philipp Pentke,de GER,GK,Hoffenheim,35,1985,3.0,0,0,0,0,0,0,0,,0,0,0,0,0,0,0,0,Matches
Pavao Pervan,at AUT,GK,Wolfsburg,32,1987,2.0,0,0,0,0,0,0,0,,0,0,0,0,0,0,1,0,Matches
Nils Petersen,de GER,FW,Freiburg,31,1988,14.5,11,7,2,6,3,3,21,14.3,18,25,1,24,9,20,28,0,Matches
Lukas Petkov,bg BUL,MF,Augsburg,19,2000,0.0,0,0,0,0,0,0,0,,0,0,0,0,0,0,0,0,Matches
Maximilian Philipp,de GER,MF,Wolfsburg,26,1994,12.3,15,6,3,6,6,5,21,23.8,16,17,0,17,6,21,3,0,Matches
Krzysztof Piątek,pl POL,FW,Hertha BSC,25,1995,18.1,9,4,1,7,1,3,22,13.6,19,11,0,11,6,15,14,0,Matches
Amos Pieper,de GER,DF,Arminia,22,1998,29.8,58,32,39,17,2,20,33,60.6,13,48,35,13,66,124,160,3,Matches
Łukasz Piszczek,pl POL,DF,Dortmund,35,1985,5.1,10,7,6,4,0,5,12,41.7,7,5,1,4,5,15,12,0,Matches
Marvin Plattenhardt,de GER,DF,Hertha BSC,28,1992,11.9,15,10,6,7,2,5,9,55.6,4,9,1,8,1,16,19,1,Matches
Alassane Pléa,fr FRA,FW,M'Gladbach,27,1993,20.0,19,9,4,10,5,5,20,25.0,15,1,0,1,5,24,7,0,Matches
Joel Pohjanpalo,fi FIN,FW,Union Berlin,25,1994,9.5,5,1,0,3,2,1,6,16.7,5,1,0,1,1,6,12,0,Matches
Joel Pohjanpalo,fi FIN,MF,Leverkusen,25,1994,0.1,0,0,0,0,0,0,0,,0,0,0,0,0,0,0,0,Matches
Marin Pongračić,hr CRO,DF,Wolfsburg,22,1997,6.4,13,9,9,3,1,6,8,75.0,2,12,5,7,11,24,27,0,Matches
Stefan Posch,at AUT,DF,Hoffenheim,23,1997,23.5,52,24,29,17,6,27,47,57.4,20,27,8,19,37,89,73,1,Matches
Yussuf Poulsen,dk DEN,FW,RB Leipzig,26,1994,15.0,10,6,1,6,3,1,17,5.9,16,16,0,16,6,16,13,0,Matches
Manuel Prietl,at AUT,MF,Arminia,28,1991,28.0,65,44,33,28,4,12,73,16.4,61,34,7,27,45,110,24,0,Matches
Grischa Prömel,de GER,MF,Union Berlin,25,1995,20.2,39,23,14,23,2,18,34,52.9,16,20,2,18,24,63,22,0,Matches
Robin Quaison,se SWE,"FW,MF",Mainz 05,26,1993,16.4,14,6,3,6,5,7,14,50.0,7,10,0,10,13,27,10,0,Matches
Nemanja Radonjić,rs SRB,"FW,MF",Hertha BSC,24,1996,6.8,5,3,2,2,1,1,5,20.0,4,1,0,1,2,7,1,0,Matches
Benito Raman,be BEL,"FW,MF",Schalke 04,25,1994,13.8,19,13,11,6,2,6,29,20.7,23,11,0,11,5,24,5,0,Matches
Milot Rashica,xk KVX,"FW,MF",Werder Bremen,24,1996,16.2,24,12,11,11,2,12,23,52.2,11,7,0,7,4,28,6,0,Matches
Daishawn Redan,nl NED,"FW,MF",Hertha BSC,19,2001,1.1,0,0,0,0,0,0,0,,0,1,0,1,0,0,0,0,Matches
Reinier,br BRA,"MF,FW",Dortmund,18,2002,2.9,9,4,6,1,2,2,4,50.0,2,4,1,3,2,11,0,0,Matches
Rocco Reitz,de GER,MF,M'Gladbach,18,2002,0.7,3,2,0,3,0,2,2,100.0,0,3,1,2,1,4,1,0,Matches
Marco Reus,de GER,"MF,FW",Dortmund,31,1989,25.3,33,16,9,16,8,9,33,27.3,24,22,2,20,14,47,13,0,Matches
Elvis Rexhbeçaj,de GER,"MF,FW",Köln,22,1997,20.4,53,32,17,27,9,19,53,35.8,34,32,7,25,26,79,18,0,Matches
Gio Reyna,us USA,"MF,FW",Dortmund,17,2002,22.0,24,13,9,8,7,9,25,36.0,16,14,1,13,10,34,11,0,Matches
Chris Richards,us USA,DF,Hoffenheim,20,2000,10.5,19,8,12,6,1,10,16,62.5,6,13,4,9,21,40,40,1,Matches
Chris Richards,us USA,DF,Bayern Munich,20,2000,1.0,0,0,0,0,0,0,0,,0,0,0,0,1,1,1,0,Matches
Marco Richter,de GER,"FW,MF",Augsburg,22,1997,15.7,17,9,3,12,2,7,23,30.4,16,10,0,10,6,23,9,0,Matches
Marc Roca,es ESP,MF,Bayern Munich,23,1996,2.0,2,2,0,0,2,0,4,0.0,4,4,1,3,2,4,1,0,Matches
Sebastian Rode,de GER,MF,Eint Frankfurt,29,1990,18.1,44,25,21,16,7,14,46,30.4,32,30,3,27,47,91,18,0,Matches
Jérôme Roussillon,fr FRA,DF,Wolfsburg,27,1993,13.7,24,12,14,8,2,11,20,55.0,9,10,1,9,19,43,28,0,Matches
Sebastian Rudy,de GER,"MF,FW",Hoffenheim,30,1990,18.6,35,26,15,15,5,16,45,35.6,29,24,4,20,13,48,21,1,Matches
Sebastian Rudy,de GER,DF,Schalke 04,30,1990,2.0,4,2,2,0,2,4,7,57.1,3,6,4,2,1,5,4,0,Matches
Georginio Rutter,fr FRA,FW,Hoffenheim,18,2002,2.7,4,4,2,2,0,1,2,50.0,1,2,0,2,0,4,2,0,Matches
Julian Ryerson,no NOR,"DF,MF",Union Berlin,22,1997,11.9,22,15,4,14,4,12,15,80.0,3,13,0,13,11,33,17,0,Matches
Frederik Rønnow,dk DEN,GK,Schalke 04,27,1992,10.5,0,0,0,0,0,0,0,,0,0,0,0,1,1,9,1,Matches
João Victor Santos Sá,br BRA,FW,Wolfsburg,26,1994,5.2,9,6,2,6,1,6,11,54.5,5,11,0,11,8,17,2,0,Matches
Marcel Sabitzer,at AUT,MF,RB Leipzig,26,1994,22.5,29,21,12,16,1,12,37,32.4,25,7,2,5,35,64,27,0,Matches
Roland Sallai,hu HUN,"MF,FW",Freiburg,23,1997,18.5,18,14,7,9,2,5,13,38.5,8,11,1,10,11,29,8,0,Matches
Lazar Samardzic,rs SRB,MF,RB Leipzig,18,2002,2.2,10,7,4,6,0,5,13,38.5,8,6,0,6,2,12,1,0,Matches
Diadie Samassékou,ml MLI,MF,Hoffenheim,24,1996,28.5,71,41,22,42,7,33,90,36.7,57,41,12,29,78,149,50,0,Matches
Jadon Sancho,eng ENG,"FW,MF",Dortmund,20,2000,22.9,18,11,4,10,4,7,16,43.8,9,20,1,19,16,34,9,0,Matches
Leroy Sané,de GER,"FW,MF",Bayern Munich,24,1996,20.1,18,10,2,10,6,13,30,43.3,17,23,1,22,9,27,8,1,Matches
Salif Sané,sn SEN,DF,Schalke 04,29,1990,11.9,17,9,9,7,1,13,23,56.5,10,25,13,12,25,42,66,0,Matches
Mohamed Sankoh,nl NED,MF,Stuttgart,16,2003,0.2,0,0,0,0,0,0,0,,0,1,0,1,0,0,0,0,Matches
Baptiste Santamaria,fr FRA,MF,Freiburg,25,1995,24.5,51,38,19,24,8,20,54,37.0,34,36,7,29,52,103,34,1,Matches
Josh Sargent,us USA,"FW,MF",Werder Bremen,20,2000,27.8,32,19,13,13,6,13,27,48.1,14,39,4,35,17,49,36,0,Matches
Bouna Sarr,sn SEN,DF,Bayern Munich,28,1992,5.0,9,8,4,3,2,3,6,50.0,3,7,0,7,10,19,7,1,Matches
Patrik Schick,cz CZE,FW,Leverkusen,24,1996,20.7,7,2,0,5,2,1,4,25.0,3,5,2,3,3,10,20,0,Matches
Sven Schipplock,de GER,"FW,MF",Arminia,31,1988,8.3,15,8,7,6,2,6,27,22.2,21,13,2,11,6,21,8,0,Matches
Xaver Schlager,at AUT,MF,Wolfsburg,22,1997,29.2,66,40,20,38,8,22,68,32.4,46,50,6,44,54,120,38,0,Matches
Keven Schlotterbeck,de GER,DF,Freiburg,23,1997,18.4,31,10,16,15,0,10,23,43.5,13,26,18,8,36,67,89,2,Matches
Nico Schlotterbeck,de GER,DF,Union Berlin,20,1999,14.3,34,19,14,19,1,18,28,64.3,10,13,6,7,31,65,29,1,Matches
Jonathan Schmid,fr FRA,"MF,DF",Freiburg,30,1990,26.6,37,19,17,13,7,16,30,53.3,14,26,10,16,28,65,38,0,Matches
Romano Schmid,at AUT,"MF,FW",Werder Bremen,20,2000,13.1,22,16,8,10,4,8,35,22.9,27,21,0,21,8,30,6,0,Matches
Benno Schmitz,de GER,DF,Köln,25,1994,4.6,14,7,6,7,1,7,13,53.8,6,8,2,6,6,20,7,0,Matches
Alessandro Schöpf,at AUT,"FW,MF",Schalke 04,26,1994,10.5,11,9,3,7,1,1,6,16.7,5,15,1,14,6,17,6,0,Matches
Nico Schulz,de GER,DF,Dortmund,27,1993,6.8,9,6,4,3,2,2,11,18.2,9,12,4,8,6,15,10,0,Matches
Alexander Schwolow,de GER,GK,Hertha BSC,28,1992,26.0,0,0,0,0,0,0,0,,0,1,0,1,0,0,6,0,Matches
Christopher Scott,de GER,"MF,FW",Bayern Munich,18,2002,0.4,2,1,0,1,1,2,2,100.0,0,0,0,0,0,2,1,0,Matches
Davie Selke,de GER,FW,Werder Bremen,25,1995,9.0,3,2,1,1,1,0,6,0.0,6,3,2,1,1,4,7,0,Matches
Suat Serdar,de GER,MF,Schalke 04,23,1997,21.7,55,35,18,33,4,17,52,32.7,35,29,4,25,23,78,21,0,Matches
Ryan Sessegnon,eng ENG,"DF,FW",Hoffenheim,20,2000,17.5,47,25,26,13,8,15,34,44.1,19,26,3,23,30,77,46,0,Matches
Nils Seufert,de GER,"MF,FW",Arminia,23,1997,3.8,12,9,2,5,5,2,8,25.0,6,3,1,2,5,17,6,0,Matches
Tim Siersleben,de GER,DF,Wolfsburg,20,2000,0.4,2,2,2,0,0,1,1,100.0,0,1,0,1,0,2,0,0,Matches
André Silva,pt POR,FW,Eint Frankfurt,24,1995,30.7,11,2,0,7,4,6,13,46.2,7,11,1,10,3,14,15,0,Matches
Jóan Símun Edmundsson,fo FRO,"FW,MF",Arminia,29,1991,0.6,0,0,0,0,0,0,0,,0,1,0,1,1,1,0,0,Matches
Daley Sinkgraven,nl NED,DF,Leverkusen,25,1995,17.4,32,17,13,16,3,18,35,51.4,17,22,5,17,23,55,23,0,Matches
Tobias Sippel,de GER,GK,M'Gladbach,32,1988,3.8,0,0,0,0,0,0,0,,0,0,0,0,1,1,4,0,Matches
Ellyes Skhiri,tn TUN,MF,Köln,25,1995,30.9,83,48,44,31,8,33,65,50.8,32,49,13,36,82,165,38,2,Matches
Robert Skov,dk DEN,"FW,MF",Hoffenheim,24,1996,12.9,19,10,9,7,3,7,16,43.8,9,9,2,7,15,34,10,1,Matches
Steven Skrzybski,de GER,"FW,DF",Schalke 04,27,1992,4.7,5,4,0,5,0,1,7,14.3,6,13,1,12,5,10,1,1,Matches
Yann Sommer,ch SUI,GK,M'Gladbach,31,1988,30.1,1,1,1,0,0,1,1,100.0,0,0,0,0,2,3,9,2,Matches
Borna Sosa,hr CRO,"DF,FW",Stuttgart,22,1998,22.7,14,10,6,6,2,8,25,32.0,17,23,4,19,31,45,74,0,Matches
Cebio Soukou,bj BEN,"FW,MF",Arminia,27,1992,5.1,12,8,5,5,2,6,11,54.5,5,3,0,3,3,15,4,0,Matches
Djibril Sow,ch SUI,MF,Eint Frankfurt,23,1997,24.2,58,33,19,32,7,18,41,43.9,23,31,8,23,51,109,17,0,Matches
Jerry St. Juste,nl NED,DF,Mainz 05,23,1996,32.0,65,38,37,26,2,20,36,55.6,16,46,27,19,64,129,82,1,Matches
Benjamin Stambouli,fr FRA,"DF,MF",Schalke 04,29,1990,21.7,45,29,24,18,3,15,37,40.5,22,42,14,28,49,94,45,1,Matches
Josip Stanišić,hr CRO,DF,Bayern Munich,20,2000,1.0,2,2,1,1,0,1,1,100.0,0,3,0,3,2,4,2,0,Matches
Niklas Stark,de GER,"DF,MF",Hertha BSC,25,1995,31.0,49,28,20,27,2,13,31,41.9,18,43,16,27,42,91,101,0,Matches
Renato Steffen,ch SUI,"FW,MF",Wolfsburg,28,1991,17.4,24,15,6,12,6,13,24,54.2,11,21,2,19,22,46,15,0,Matches
Pascal Stenzel,de GER,DF,Stuttgart,24,1996,14.2,33,14,15,17,1,22,50,44.0,28,19,4,15,26,59,39,1,Matches
Lars Stindl,de GER,"MF,FW",M'Gladbach,31,1988,21.8,24,17,3,16,5,7,32,21.9,25,26,3,23,13,37,14,0,Matches
Kevin Stöger,at AUT,"MF,FW",Mainz 05,26,1993,6.0,12,6,2,9,1,5,16,31.3,11,5,0,5,6,18,4,0,Matches
Tobias Strobl,de GER,MF,Augsburg,30,1990,20.5,21,10,12,9,0,10,30,33.3,20,21,8,13,28,49,27,0,Matches
Marek Suchý,cz CZE,DF,Augsburg,32,1988,3.4,4,2,1,3,0,1,2,50.0,1,3,3,0,4,8,9,0,Matches
Niklas Süle,de GER,DF,Bayern Munich,24,1995,16.7,32,21,15,14,3,13,21,61.9,8,24,12,12,21,53,36,1,Matches
Ádám Szalai,hu HUN,FW,Mainz 05,32,1987,8.1,7,6,3,2,2,2,8,25.0,6,4,1,3,2,9,4,0,Matches
Frederik Sørensen,dk DEN,DF,Köln,28,1992,1.1,2,1,0,2,0,1,1,100.0,0,2,0,2,0,2,0,0,Matches
Alexander Sørloth,no NOR,FW,RB Leipzig,24,1995,16.0,7,5,0,5,2,2,14,14.3,12,13,2,11,3,10,13,0,Matches
Jonathan Tah,de GER,DF,Leverkusen,24,1996,24.7,30,17,19,9,2,11,21,52.4,10,19,12,7,33,63,89,1,Matches
Edmond Tapsoba,bf BFA,DF,Leverkusen,21,1999,29.5,54,28,35,18,1,21,45,46.7,24,55,29,26,48,102,96,0,Matches
Niklas Tauer,de GER,"MF,DF",Mainz 05,19,2001,0.8,1,1,0,1,0,1,2,50.0,1,3,1,2,3,4,1,0,Matches
Lino Tempelmann,de GER,MF,Freiburg,21,1999,3.0,5,3,2,2,1,0,4,0.0,4,6,1,5,2,7,6,0,Matches
Cedric Teuchert,de GER,"FW,MF",Union Berlin,23,1997,8.4,7,5,2,4,1,3,16,18.8,13,12,0,12,5,12,6,0,Matches
Malick Thiaw,de GER,DF,Schalke 04,18,2001,16.1,42,27,24,17,1,15,26,57.7,11,17,12,5,33,75,70,0,Matches
Jan Thielmann,de GER,"FW,MF",Köln,18,2002,11.4,11,6,1,8,2,5,9,55.6,4,10,1,9,9,20,2,0,Matches
Erik Thommy,de GER,"MF,DF",Stuttgart,25,1994,3.5,3,1,0,3,0,0,3,0.0,3,3,0,3,3,6,4,0,Matches
Marcus Thuram,fr FRA,"FW,MF",M'Gladbach,22,1997,19.2,24,14,9,10,5,10,23,43.5,13,27,4,23,15,39,13,1,Matches
Steffen Tigges,de GER,"FW,DF",Dortmund,22,1998,0.6,4,4,0,1,3,2,3,66.7,1,1,0,1,0,4,1,0,Matches
Guus Til,nl NED,FW,Freiburg,22,1997,1.4,4,3,2,1,1,2,3,66.7,1,2,0,2,2,6,2,0,Matches
Corentin Tolisso,fr FRA,MF,Bayern Munich,25,1994,8.7,19,19,4,11,4,9,29,31.0,20,15,2,13,6,25,8,0,Matches
Ömer Toprak,tr TUR,DF,Werder Bremen,31,1989,21.6,23,16,15,6,2,12,24,50.0,12,27,16,11,36,59,115,1,Matches
Jordan Torunarigha,de GER,DF,Hertha BSC,22,1997,10.8,7,4,7,0,0,5,8,62.5,3,8,2,6,15,22,54,1,Matches
Almamy Touré,ml MLI,DF,Eint Frankfurt,24,1996,7.8,18,12,8,7,3,10,14,71.4,4,5,1,4,8,26,22,0,Matches
Lucas Tousart,fr FRA,MF,Hertha BSC,23,1997,23.2,33,18,16,15,2,13,27,48.1,14,33,6,27,40,73,52,0,Matches
Ibrahima Traoré,gn GUI,"FW,DF",M'Gladbach,32,1988,1.1,4,1,1,2,1,0,0,,0,2,0,2,0,4,0,0,Matches
Kevin Trapp,de GER,GK,Eint Frankfurt,30,1990,33.0,0,0,0,0,0,0,1,0.0,1,1,0,1,3,3,11,3,Matches
Christopher Trimmel,at AUT,"DF,FW",Union Berlin,33,1987,28.6,50,25,28,18,4,28,54,51.9,26,32,7,25,50,100,99,0,Matches
Tuta,br BRA,DF,Eint Frankfurt,21,1999,16.2,35,20,22,13,0,24,43,55.8,19,19,2,17,29,64,53,0,Matches
Dayot Upamecano,fr FRA,DF,RB Leipzig,21,1998,25.9,37,30,18,19,0,14,20,70.0,6,25,14,11,33,70,74,2,Matches
Mark Uth,de GER,"FW,MF",Schalke 04,28,1991,16.6,25,13,13,10,2,5,23,21.7,18,21,0,21,5,30,10,0,Matches
Ruben Vargas,ch SUI,"MF,FW",Augsburg,21,1998,17.9,18,12,6,9,3,1,16,6.3,15,26,2,24,18,36,27,0,Matches
Miloš Veljković,rs SRB,DF,Werder Bremen,24,1995,19.1,24,14,17,6,1,15,31,48.4,16,22,9,13,29,53,94,1,Matches
Michel Vlap,nl NED,"MF,FW",Arminia,23,1997,4.1,1,1,0,1,0,0,8,0.0,8,4,0,4,5,6,3,0,Matches
Andreas Voglsammer,de GER,"FW,MF",Arminia,28,1992,11.1,12,8,6,6,0,8,17,47.1,9,11,0,11,3,15,11,0,Matches
Kevin Vogt,de GER,DF,Hoffenheim,28,1991,20.5,18,12,11,6,1,12,21,57.1,9,21,12,9,16,34,71,0,Matches
Wout Weghorst,nl NED,FW,Wolfsburg,27,1992,32.7,13,8,2,8,3,4,20,20.0,16,17,3,14,4,17,26,0,Matches
Mitchell Weiser,de GER,DF,Leverkusen,26,1994,2.5,4,1,1,2,1,2,4,50.0,2,1,0,1,3,7,4,0,Matches
Wendell,br BRA,DF,Leverkusen,27,1993,16.2,53,35,27,18,8,23,49,46.9,26,26,3,23,25,78,39,1,Matches
Oscar Wendt,se SWE,DF,M'Gladbach,34,1985,13.9,12,6,2,9,1,4,12,33.3,8,18,4,14,14,26,23,0,Matches
William,br BRA,"MF,FW",Wolfsburg,25,1995,0.0,0,0,0,0,0,0,0,,0,0,0,0,0,0,0,0,Matches
William,br BRA,"DF,FW",Schalke 04,25,1995,5.3,14,10,10,4,0,5,15,33.3,10,16,5,11,11,25,15,1,Matches
Marten Winkler,de GER,FW,Hertha BSC,17,2002,0.0,0,0,0,0,0,0,0,,0,0,0,0,0,0,0,0,Matches
Florian Wirtz,de GER,MF,Leverkusen,17,2003,24.7,35,18,8,22,5,11,37,29.7,26,27,1,26,9,44,8,0,Matches
Axel Witsel,be BEL,MF,Dortmund,31,1989,12.6,18,12,6,11,1,8,16,50.0,8,13,3,10,22,40,13,0,Matches
Hannes Wolf,at AUT,"MF,FW",M'Gladbach,21,1999,15.3,26,13,8,10,8,8,36,22.2,28,18,1,17,9,35,4,0,Matches
Marius Wolf,de GER,"MF,DF",Köln,25,1995,28.3,35,19,19,13,3,13,38,34.2,25,29,3,26,28,63,47,1,Matches
Nick Woltemade,de GER,"MF,FW",Werder Bremen,18,2002,1.6,3,2,1,1,1,2,4,50.0,2,1,0,1,0,3,0,0,Matches
Jeong Woo-yeong,kr KOR,"FW,MF",Freiburg,20,1999,9.1,9,5,1,6,2,2,11,18.2,9,8,1,7,11,20,11,0,Matches
Joscha Wosz,de GER,DF,RB Leipzig,18,2002,0.4,1,1,1,0,0,0,0,,0,1,0,1,1,2,0,0,Matches
Reinhold Yabo,de GER,"MF,FW",Arminia,28,1992,7.2,5,2,2,2,1,2,9,22.2,7,6,1,5,4,9,1,0,Matches
Amin Younes,de GER,MF,Eint Frankfurt,26,1993,15.5,25,14,8,10,7,6,32,18.8,26,19,1,18,13,38,4,0,Matches
Dan-Axel Zagadou,fr FRA,DF,Dortmund,21,1999,3.1,2,2,2,0,0,0,0,,0,3,2,1,6,8,13,0,Matches
Denis Zakaria,ch SUI,"MF,DF",M'Gladbach,23,1996,15.8,30,15,12,15,3,11,20,55.0,9,20,7,13,23,53,29,1,Matches
Deyovaisio Zeefuik,nl NED,"DF,FW",Hertha BSC,22,1998,10.1,13,9,8,3,2,8,19,42.1,11,15,3,12,12,25,36,0,Matches
Robin Zentner,de GER,GK,Mainz 05,25,1994,31.0,1,1,1,0,0,1,3,33.3,2,0,0,0,3,4,9,2,Matches
Ron-Robert Zieler,de GER,GK,Köln,31,1989,0.6,0,0,0,0,0,0,0,,0,0,0,0,0,0,0,0,Matches
Joshua Zirkzee,nl NED,FW,Bayern Munich,19,2001,1.0,1,0,0,1,0,1,2,50.0,1,0,0,0,0,1,0,0,Matches
Steven Zuber,ch SUI,"DF,MF",Eint Frankfurt,28,1991,6.5,24,12,8,13,3,8,16,50.0,8,4,1,3,4,28,1,0,Matches
