player,nationality,position,team,age,birth_year,minutes_90s,tackles,tackles_won,tackles_def_3rd,tackles_mid_3rd,tackles_att_3rd,challenge_tackles,challenges,challenge_tackles_pct,challenges_lost,blocks,blocked_shots,blocked_passes,interceptions,tackles_interceptions,clearances,errors,matches
Brenden Aaronson,us USA,MF,Union Berlin,23-066,2000,3.6,8,6,3,4,1,5,7,71.4,2,9,0,9,0,8,1,0,Matches
Paxten Aaronson,us USA,MF,Eint Frankfurt,20-123,2003,1.1,2,2,1,1,0,1,1,100.0,0,2,0,2,0,2,0,0,Matches
Junior Adamu,at AUT,"FW,MF",Freiburg,22-204,2001,1.1,5,1,1,2,2,1,2,50.0,1,1,0,1,0,5,1,0,Matches
Sargis Adamyan,am ARM,"FW,MF",Köln,30-218,1993,1.6,3,2,0,2,1,1,2,50.0,1,2,0,2,0,3,2,0,Matches
Karim Adeyemi,de GER,"FW,MF",Dortmund,21-343,2002,4.1,7,7,3,2,2,3,10,30.0,7,6,0,6,2,9,1,0,Matches
Amine Adli,ma MAR,"MF,DF",Leverkusen,23-231,2000,2.9,6,1,1,2,3,4,6,66.7,2,5,1,4,3,9,1,0,Matches
Felix Agu,de GER,"MF,DF",Werder Bremen,24-091,1999,2.2,2,2,1,0,1,1,2,50.0,1,1,0,1,2,4,6,0,Matches
Ludovic Ajorque,fr FRA,FW,Mainz 05,29-305,1994,9.8,2,2,1,1,0,1,6,16.7,5,5,1,4,0,2,4,0,Matches
Kevin Akpoguma,ng NGA,DF,Hoffenheim,28-252,1995,6.4,21,10,15,5,1,15,19,78.9,4,14,5,9,10,31,16,0,Matches
Faride Alidou,de GER,"FW,MF",Köln,22-162,2001,3.0,5,1,2,2,1,2,7,28.6,5,7,1,6,3,8,1,1,Matches
Nadiem Amiri,de GER,"MF,FW",Leverkusen,27-061,1996,0.2,2,0,0,2,0,0,2,0.0,2,0,0,0,0,2,0,0,Matches
Kofi Amoako,de GER,MF,Wolfsburg,18-235,2005,0.0,0,0,0,0,0,0,0,,0,0,0,0,0,0,0,0,Matches
Robert Andrich,de GER,"MF,DF",Leverkusen,29-096,1994,3.7,3,3,0,2,1,1,3,33.3,2,5,2,3,6,9,7,0,Matches
Waldemar Anton,de GER,DF,Stuttgart,27-160,1996,15.6,19,14,8,10,1,12,21,57.1,9,15,10,5,21,40,72,1,Matches
Christopher Antwi-Adjei,gh GHA,"FW,MF",Bochum,29-323,1994,7.1,12,7,5,5,2,7,15,46.7,8,7,2,5,0,12,5,1,Matches
Maximilian Arnold,de GER,MF,Wolfsburg,29-214,1994,10.9,20,14,5,10,5,11,20,55.0,9,7,1,6,11,31,23,0,Matches
Arthur,br BRA,DF,Leverkusen,20-285,2003,0.4,2,2,1,0,1,2,2,100.0,0,0,0,0,0,2,1,0,Matches
Takuma Asano,jp JPN,"FW,MF",Bochum,29-047,1994,13.1,10,2,2,4,4,4,13,30.8,9,6,1,5,2,12,8,0,Matches
Noah Atubolu,de GER,GK,Freiburg,21-216,2002,16.0,0,0,0,0,0,0,0,,0,0,0,0,0,0,3,0,Matches
Matthias Bader,de GER,"DF,MF",Darmstadt 98,26-193,1997,9.8,20,10,12,4,4,11,22,50.0,11,10,2,8,15,35,10,0,Matches
Ridle Baku,de GER,"DF,MF",Wolfsburg,25-263,1998,10.0,12,7,7,2,3,7,15,46.7,8,14,0,14,11,23,30,1,Matches
Samuel Bamba,de GER,FW,Dortmund,19-317,2004,0.5,1,1,1,0,0,1,2,50.0,1,0,0,0,0,1,1,0,Matches
Aymen Barkok,ma MAR,"MF,FW",Mainz 05,25-220,1998,3.6,9,5,2,6,1,3,6,50.0,3,7,0,7,2,11,1,0,Matches
Leandro Barreiro Martins,lu LUX,MF,Mainz 05,23-358,2000,13.9,29,21,8,17,4,10,22,45.5,12,25,10,15,25,54,21,0,Matches
Daniel Batz,de GER,GK,Mainz 05,32-349,1991,4.0,0,0,0,0,0,0,0,,0,0,0,0,0,0,3,0,Matches
Maximilian Bauer,de GER,DF,Augsburg,23-321,2000,5.5,9,5,5,4,0,3,9,33.3,6,8,7,1,8,17,24,1,Matches
Elias Baum,de GER,"MF,DF",Eint Frankfurt,18-062,2005,0.2,1,0,0,0,1,0,0,,0,1,1,0,0,1,0,0,Matches
Oliver Baumann,de GER,GK,Hoffenheim,33-208,1990,16.0,1,1,1,0,0,1,1,100.0,0,0,0,0,0,1,7,0,Matches
Christoph Baumgartner,at AUT,MF,RB Leipzig,24-148,1999,6.9,16,9,6,7,3,10,17,58.8,7,10,0,10,3,19,5,0,Matches
Ihlas Bebou,tg TOG,"FW,DF",Hoffenheim,29-248,1994,8.0,11,6,5,4,2,5,11,45.5,6,7,0,7,7,18,8,0,Matches
Adrian Beck,de GER,MF,Heidenheim,26-201,1997,6.3,10,5,2,7,1,6,13,46.2,7,5,0,5,3,13,9,0,Matches
Sheraldo Becker,sr SUR,"FW,MF",Union Berlin,28-321,1995,7.2,3,3,0,2,1,0,2,0.0,2,2,0,2,0,3,2,0,Matches
Kevin Behrens,de GER,FW,Union Berlin,32-327,1991,12.1,12,10,3,6,3,1,4,25.0,3,6,2,4,4,16,15,0,Matches
Maximilian Beier,de GER,FW,Hoffenheim,21-071,2002,10.5,5,2,1,2,2,2,6,33.3,4,7,0,7,0,5,6,0,Matches
Stefan Bell,de GER,DF,Mainz 05,32-125,1991,7.4,8,8,7,1,0,4,8,50.0,4,7,5,2,6,14,30,0,Matches
Ramy Bensebaini,dz ALG,DF,Dortmund,28-255,1995,11.1,32,20,19,11,2,22,32,68.8,10,22,7,15,16,48,36,0,Matches
Mergim Berisha,de GER,FW,Hoffenheim,25-230,1998,1.6,0,0,0,0,0,0,0,,0,2,1,1,0,0,0,0,Matches
Mergim Berisha,de GER,FW,Augsburg,25-230,1998,1.4,0,0,0,0,0,0,0,,0,1,0,1,0,0,3,0,Matches
Bernardo,br BRA,DF,Bochum,28-227,1995,16.0,49,32,33,13,3,21,33,63.6,12,36,14,22,27,76,56,1,Matches
Matúš Bero,sk SVK,"MF,FW",Bochum,28-112,1995,6.4,12,8,6,4,2,6,12,50.0,6,9,0,9,3,15,5,0,Matches
Jan-Niklas Beste,de GER,"FW,MF",Heidenheim,24-357,1999,13.0,25,14,9,6,10,8,21,38.1,13,23,0,23,8,33,11,0,Matches
Tom Bischof,de GER,"MF,FW",Hoffenheim,18-182,2005,1.6,7,4,5,1,1,1,8,12.5,7,1,0,1,1,8,2,0,Matches
Leonardo Bittencourt,de GER,MF,Werder Bremen,30-008,1993,8.4,21,12,13,7,1,6,21,28.6,15,11,0,11,7,28,4,0,Matches
Janis Blaswich,de GER,GK,RB Leipzig,32-239,1991,16.0,1,1,1,0,0,0,0,,0,0,0,0,0,1,4,3,Matches
Victor Boniface,ng NGA,FW,Leverkusen,23-004,2000,14.2,6,4,0,1,5,1,4,25.0,3,5,0,5,0,6,10,0,Matches
Leonardo Bonucci,it ITA,DF,Union Berlin,36-240,1987,5.1,6,5,2,4,0,4,4,100.0,0,5,3,2,7,13,16,0,Matches
Yvandro Borges Sanches,lu LUX,"MF,FW",M'Gladbach,19-217,2004,0.2,0,0,0,0,0,0,0,,0,0,0,0,0,0,0,0,Matches
Sebastiaan Bornauw,be BEL,DF,Wolfsburg,24-280,1999,5.4,8,2,6,2,0,6,9,66.7,3,11,7,4,5,13,21,0,Matches
Rafael Borré,co COL,FW,Werder Bremen,28-103,1995,9.2,9,6,2,4,3,5,13,38.5,8,5,0,5,2,11,6,0,Matches
Julian Brandt,de GER,"MF,FW",Dortmund,27-239,1996,13.5,12,11,7,5,0,7,18,38.9,11,10,1,9,7,19,8,0,Matches
Tim Breithaupt,de GER,MF,Augsburg,21-323,2002,2.9,5,3,4,1,0,4,6,66.7,2,4,2,2,1,6,5,0,Matches
Maximilian Breunig,de GER,FW,Freiburg,23-135,2000,0.1,0,0,0,0,0,0,0,,0,1,0,1,0,0,0,0,Matches
John Brooks,us USA,DF,Hoffenheim,30-333,1993,12.0,20,11,13,6,1,10,22,45.5,12,22,13,9,21,41,80,1,Matches
Moritz Broschinski,de GER,"FW,MF",Bochum,23-095,2000,3.4,4,2,1,2,1,0,2,0.0,2,1,1,0,0,4,1,0,Matches
Alexander Brunst,de GER,GK,Darmstadt 98,28-173,1995,1.0,0,0,0,0,0,0,0,,0,0,0,0,0,0,0,0,Matches
Marius Bülter,de GER,"DF,FW",Hoffenheim,30-273,1993,8.7,10,5,6,3,1,6,13,46.2,7,8,0,8,6,16,12,0,Matches
Jonathan Burkardt,de GER,"MF,FW",Mainz 05,23-169,2000,2.1,0,0,0,0,0,0,0,,0,5,2,3,2,2,0,0,Matches
Oliver Burke,sct SCO,FW,Werder Bremen,26-264,1997,0.4,0,0,0,0,0,0,2,0.0,2,0,0,0,0,0,0,0,Matches
Marnon Busch,de GER,DF,Heidenheim,29-019,1994,3.2,5,3,4,1,0,3,7,42.9,4,7,0,7,4,9,3,0,Matches
Aurélio Buta,pt POR,"DF,MF",Eint Frankfurt,26-320,1997,10.5,22,13,11,7,4,12,22,54.5,10,12,3,9,6,28,20,0,Matches
Jamie Bynoe-Gittens,eng ENG,"FW,DF",Dortmund,19-141,2004,4.4,6,3,4,2,0,2,7,28.6,5,3,1,2,2,8,5,0,Matches
Anthony Caci,fr FRA,DF,Mainz 05,26-179,1997,12.8,21,8,14,7,0,15,22,68.2,7,17,3,14,15,36,21,0,Matches
Emre Can,de GER,MF,Dortmund,29-349,1994,10.6,35,25,20,12,3,17,24,70.8,7,17,2,15,10,45,16,1,Matches
Irvin Cardona,fr FRA,"MF,DF",Augsburg,26-141,1997,0.6,1,1,0,0,1,1,3,33.3,2,1,0,1,0,1,1,0,Matches
Rasmus Carstensen,dk DEN,"DF,FW",Köln,23-077,2000,11.7,29,13,13,13,3,19,35,54.3,16,27,6,21,13,42,30,1,Matches
Fabio Carvalho,pt POR,MF,RB Leipzig,21-119,2002,1.8,3,1,0,2,1,1,3,33.3,2,8,0,8,0,3,1,0,Matches
Koen Casteels,be BEL,GK,Wolfsburg,31-185,1992,13.0,2,1,2,0,0,2,3,66.7,1,0,0,0,0,2,7,2,Matches
Václav Černý,cz CZE,"FW,MF",Wolfsburg,26-071,1997,6.1,5,2,2,3,0,1,9,11.1,8,9,0,9,6,11,4,0,Matches
Julian Chabot,de GER,DF,Köln,25-318,1998,13.4,29,19,18,11,0,15,22,68.2,7,31,18,13,25,54,63,0,Matches
Fares Chaïbi,dz ALG,"MF,FW",Eint Frankfurt,21-029,2002,10.4,17,10,4,7,6,4,7,57.1,3,20,0,20,2,19,4,0,Matches
Fabio Chiarodia,it ITA,"DF,MF",M'Gladbach,18-205,2005,0.7,4,2,4,0,0,2,2,100.0,0,1,1,0,1,5,6,0,Matches
Kingsley Coman,fr FRA,FW,Bayern Munich,27-197,1996,9.3,11,6,5,3,3,8,13,61.5,5,12,1,11,2,13,5,0,Matches
Bambasé Conté,de GER,"FW,MF",Hoffenheim,20-173,2003,0.0,1,1,1,0,0,0,0,,0,0,0,0,0,1,0,0,Matches
Danny da Costa,de GER,DF,Mainz 05,30-167,1993,8.1,15,7,7,6,2,6,16,37.5,10,14,3,11,14,29,20,0,Matches
Nicolas Cozza,fr FRA,DF,Wolfsburg,24-353,1999,2.4,7,5,3,4,0,2,7,28.6,5,2,0,2,4,11,3,0,Matches
Tomáš Čvančara,cz CZE,FW,M'Gladbach,23-136,2000,7.1,2,2,0,2,0,0,1,0.0,1,3,1,2,0,2,8,0,Matches
Finn Dahmen,de GER,GK,Augsburg,25-275,1998,16.0,0,0,0,0,0,0,0,,0,0,0,0,0,0,11,3,Matches
Lukas Daschner,de GER,"MF,FW",Bochum,25-087,1998,3.4,5,3,2,2,1,3,7,42.9,4,5,0,5,2,7,1,0,Matches
David Datro Fofana,ci CIV,"FW,MF",Union Berlin,21-005,2002,7.6,10,7,3,5,2,4,9,44.4,5,4,0,4,0,10,5,0,Matches
Alphonso Davies,ca CAN,DF,Bayern Munich,23-055,2000,12.1,21,12,12,9,0,11,22,50.0,11,17,1,16,11,32,23,1,Matches
Olivier Deman,be BEL,DF,Werder Bremen,23-265,2000,9.2,21,12,16,3,2,14,25,56.0,11,21,7,14,9,30,19,0,Matches
Ermedin Demirović,ba BIH,"MF,FW",Augsburg,25-277,1998,15.4,14,8,4,9,1,7,23,30.4,16,16,1,15,5,19,14,0,Matches
Sepp van den Berg,nl NED,DF,Mainz 05,22-007,2001,13.5,24,14,12,10,2,8,13,61.5,5,29,12,17,21,45,51,1,Matches
Florian Dietz,de GER,FW,Köln,25-146,1998,0.5,0,0,0,0,0,0,0,,0,1,0,1,0,0,0,0,Matches
Junior Dina Ebimbe,fr FRA,"MF,DF",Eint Frankfurt,23-036,2000,10.6,21,13,5,10,6,8,19,42.1,11,15,3,12,3,24,17,0,Matches
Eren Dinkçi,de GER,"FW,MF",Heidenheim,22-014,2001,13.4,15,9,9,5,1,7,17,41.2,10,15,0,15,4,19,12,0,Matches
Ritsu Doan,jp JPN,"MF,FW",Freiburg,25-194,1998,11.8,23,13,11,8,4,9,17,52.9,8,11,1,10,3,26,14,0,Matches
Danilho Doekhi,nl NED,DF,Union Berlin,25-180,1998,8.0,14,10,9,5,0,5,9,55.6,4,13,3,10,15,29,25,0,Matches
Niklas Dorsch,de GER,MF,Augsburg,25-346,1998,11.7,28,20,10,18,0,11,25,44.0,14,11,8,3,12,40,18,0,Matches
Nikola Dovedan,at AUT,"MF,FW",Heidenheim,29-174,1994,2.7,7,5,0,7,0,2,8,25.0,6,4,0,4,0,7,1,0,Matches
Damion Downs,de GER,"FW,MF",Köln,19-174,2004,0.3,0,0,0,0,0,0,0,,0,0,0,0,0,0,0,0,Matches
Dion Drena Beljo,hr CRO,"FW,MF",Augsburg,21-301,2002,4.3,0,0,0,0,0,0,1,0.0,1,5,0,5,1,1,2,0,Matches
Marvin Ducksch,de GER,FW,Werder Bremen,29-295,1994,14.1,5,2,4,1,0,3,7,42.9,4,0,0,0,1,6,13,0,Matches
Maximilian Eggestein,de GER,MF,Freiburg,27-019,1996,15.5,20,8,11,6,3,3,13,23.1,10,25,12,13,17,37,23,0,Matches
Lilian Egloff,de GER,"MF,DF",Stuttgart,21-129,2002,1.2,4,1,3,1,0,2,4,50.0,2,3,1,2,1,5,0,0,Matches
Nico Elvedi,ch SUI,DF,M'Gladbach,27-088,1996,11.9,19,8,14,4,1,12,15,80.0,3,10,6,4,16,35,57,1,Matches
Arne Engels,be BEL,"MF,DF",Augsburg,20-110,2003,7.6,12,8,0,10,2,4,12,33.3,8,14,1,13,6,18,9,0,Matches
Ohis Felix Uduokhai,de GER,DF,Augsburg,26-109,1997,14.5,16,8,10,4,2,7,11,63.6,4,13,10,3,22,38,82,1,Matches
Edimilson Fernandes,ch SUI,DF,Mainz 05,27-256,1996,9.7,17,11,12,5,0,11,16,68.8,5,8,2,6,21,38,36,0,Matches
Nacho Ferri,es ESP,"FW,MF",Eint Frankfurt,19-083,2004,0.6,3,3,1,2,0,2,2,100.0,0,0,0,0,0,3,2,0,Matches
Max Finkgräfe,de GER,"DF,MF",Köln,19-275,2004,3.1,6,2,4,2,0,3,14,21.4,11,4,1,3,4,10,6,0,Matches
Jonas Föhrenbach,de GER,DF,Heidenheim,27-335,1996,14.1,21,14,12,6,3,9,22,40.9,13,14,8,6,12,33,26,0,Matches
Emil Forsberg,se SWE,"MF,FW",RB Leipzig,32-065,1991,5.2,7,3,2,5,0,5,12,41.7,7,7,0,7,0,7,5,0,Matches
Philipp Förster,de GER,"MF,FW",Bochum,28-326,1995,2.4,4,3,2,0,2,2,4,50.0,2,2,0,2,4,8,1,0,Matches
Bartol Franjić,hr CRO,MF,Darmstadt 98,23-347,2000,6.0,2,2,1,0,1,2,13,15.4,11,7,0,7,16,18,17,0,Matches
Marco Friedl,at AUT,DF,Werder Bremen,25-286,1998,11.4,26,16,18,8,0,20,29,69.0,9,27,17,10,14,40,55,0,Matches
Marvin Friedrich,de GER,DF,M'Gladbach,28-014,1995,5.4,10,6,8,1,1,7,8,87.5,1,13,10,3,3,13,30,0,Matches
Jeremie Frimpong,nl NED,DF,Leverkusen,23-017,2000,14.6,13,8,8,2,3,5,12,41.7,7,20,0,20,5,18,6,0,Matches
Chris Führich,de GER,"FW,MF",Stuttgart,25-352,1998,13.9,15,11,2,8,5,9,25,36.0,16,16,0,16,4,19,2,0,Matches
Niclas Füllkrug,de GER,FW,Werder Bremen,30-321,1993,2.0,1,1,0,1,0,1,1,100.0,0,2,1,1,0,1,1,0,Matches
Niclas Füllkrug,de GER,FW,Dortmund,30-321,1993,11.2,3,2,0,3,0,1,2,50.0,1,5,1,4,0,3,12,0,Matches
Cristian Gamboa,cr CRC,DF,Bochum,34-064,1989,10.5,17,12,8,8,1,10,25,40.0,15,9,1,8,11,28,25,1,Matches
Yannick Gerhardt,de GER,"MF,FW",Wolfsburg,29-289,1994,7.7,4,3,2,1,1,1,10,10.0,9,9,2,7,4,8,13,0,Matches
Anwar El Ghazi,nl NED,"MF,DF",Mainz 05,28-238,1995,0.6,0,0,0,0,0,0,1,0.0,1,0,0,0,0,0,0,0,Matches
Benedikt Gimber,de GER,DF,Heidenheim,26-311,1997,6.7,19,11,11,7,1,12,14,85.7,2,8,7,1,7,26,35,0,Matches
Matthias Ginter,de GER,DF,Freiburg,29-342,1994,14.3,17,9,11,6,0,10,20,50.0,10,27,17,10,13,30,61,0,Matches
Klaus Gjasula,al ALB,"DF,MF",Darmstadt 98,34-013,1989,7.0,22,11,9,13,0,6,10,60.0,4,8,4,4,9,31,26,0,Matches
Serge Gnabry,de GER,"FW,MF",Bayern Munich,28-166,1995,2.5,3,2,0,3,0,2,9,22.2,7,3,0,3,0,3,2,0,Matches
Leon Goretzka,de GER,MF,Bayern Munich,28-324,1995,9.2,11,7,5,3,3,5,16,31.3,11,12,0,12,11,22,13,0,Matches
Robin Gosens,de GER,"DF,MF",Union Berlin,29-175,1994,10.6,31,20,9,19,3,16,21,76.2,5,24,2,22,18,49,27,0,Matches
Mario Götze,de GER,"MF,FW",Eint Frankfurt,31-207,1992,8.7,19,11,8,6,5,12,24,50.0,12,11,0,11,4,23,4,0,Matches
Jeffrey Gouweleeuw,nl NED,DF,Augsburg,32-170,1991,12.0,13,9,5,7,1,5,7,71.4,2,18,6,12,17,30,55,0,Matches
Jens Grahl,de GER,GK,Eint Frankfurt,35-096,1988,1.0,0,0,0,0,0,0,0,,0,0,0,0,0,0,1,0,Matches
Ryan Gravenberch,nl NED,FW,Bayern Munich,21-225,2002,0.1,0,0,0,0,0,0,0,,0,0,0,0,0,0,0,0,Matches
Michael Gregoritsch,at AUT,FW,Freiburg,29-253,1994,6.4,3,2,1,1,1,0,4,0.0,4,8,1,7,4,7,10,0,Matches
Vincenzo Grifo,it ITA,"MF,FW",Freiburg,30-264,1993,12.2,14,11,5,6,3,6,14,42.9,8,11,0,11,5,19,8,0,Matches
Florian Grillitsch,at AUT,MF,Hoffenheim,28-142,1995,8.6,15,12,9,5,1,6,17,35.3,11,12,1,11,13,28,7,1,Matches
Álex Grimaldo,es ESP,DF,Leverkusen,28-098,1995,15.9,27,13,15,4,8,20,32,62.5,12,18,4,14,10,37,24,0,Matches
Christian Groß,de GER,"MF,DF",Werder Bremen,34-322,1989,5.1,10,6,6,4,0,4,15,26.7,11,7,2,5,5,15,9,1,Matches
Brajan Gruda,de GER,"MF,FW",Mainz 05,19-210,2004,8.9,6,4,1,3,2,5,10,50.0,5,12,0,12,3,9,3,0,Matches
Ilia Gruev,bg BUL,MF,Werder Bremen,23-235,2000,0.0,0,0,0,0,0,0,0,,0,0,0,0,0,0,0,0,Matches
Raphaël Guerreiro,pt POR,"MF,DF",Bayern Munich,30-005,1993,3.3,8,7,2,4,2,3,5,60.0,2,1,0,1,4,12,2,1,Matches
Josuha Guilavogui,fr FRA,DF,Mainz 05,33-099,1990,0.3,2,1,2,0,0,1,1,100.0,0,3,1,2,1,3,2,0,Matches
Serhou Guirassy,gn GUI,FW,Stuttgart,27-290,1996,11.7,3,2,0,3,0,1,3,33.3,2,4,1,3,2,5,13,0,Matches
Manuel Gulde,de GER,DF,Freiburg,32-318,1991,8.0,12,10,7,4,1,5,5,100.0,0,9,6,3,12,24,21,0,Matches
Robert Gumny,pl POL,DF,Augsburg,25-206,1998,5.1,6,5,1,3,2,1,5,20.0,4,13,5,8,7,13,12,0,Matches
Christian Günter,de GER,DF,Freiburg,30-302,1993,1.0,1,0,1,0,0,0,0,,0,2,1,1,0,1,2,0,Matches
Janik Haberer,de GER,MF,Union Berlin,29-269,1994,8.6,23,18,8,10,5,16,30,53.3,14,12,2,10,8,31,6,0,Matches
Robin Hack,de GER,"MF,FW",M'Gladbach,25-122,1998,3.7,3,1,1,2,0,0,7,0.0,7,6,0,6,3,6,7,0,Matches
Amadou Haidara,ml MLI,MF,RB Leipzig,25-330,1998,7.1,17,12,9,6,2,7,15,46.7,8,12,1,11,10,27,8,0,Matches
Sébastien Haller,ci CIV,FW,Dortmund,29-188,1994,4.0,1,0,0,1,0,1,1,100.0,0,4,1,3,0,1,7,0,Matches
Andreas Hanche-Olsen,no NOR,DF,Mainz 05,26-344,1997,0.7,3,0,2,1,0,1,1,100.0,0,0,0,0,0,3,2,0,Matches
Genki Haraguchi,jp JPN,MF,Stuttgart,32-232,1991,0.2,1,1,1,0,0,0,0,,0,0,0,0,0,1,1,0,Matches
Makoto Hasebe,jp JPN,"DF,MF",Eint Frankfurt,39-343,1984,0.4,2,2,2,0,0,2,2,100.0,0,0,0,0,0,2,1,0,Matches
Thorgan Hazard,be BEL,DF,Dortmund,30-273,1993,0.1,0,0,0,0,0,0,0,,0,0,0,0,0,0,0,0,Matches
Dominique Heintz,de GER,DF,Köln,30-134,1993,4.6,11,5,6,5,0,7,10,70.0,3,6,1,5,3,14,20,0,Matches
Benjamin Henrichs,de GER,DF,RB Leipzig,26-307,1997,13.9,30,18,13,14,3,10,26,38.5,16,22,1,21,14,44,10,0,Matches
Patrick Herrmann,de GER,"DF,FW",M'Gladbach,32-318,1991,0.5,2,2,1,0,1,1,1,100.0,0,0,0,0,1,3,1,0,Matches
Piero Hincapié,ec ECU,DF,Leverkusen,21-352,2002,3.3,3,2,2,1,0,2,2,100.0,0,0,0,0,4,7,6,0,Matches
Adam Hložek,cz CZE,"FW,MF",Leverkusen,21-155,2002,1.0,2,1,1,1,0,1,1,100.0,0,0,0,0,2,4,0,0,Matches
Nicolas Höfler,de GER,MF,Freiburg,33-293,1990,11.9,23,17,15,6,2,8,21,38.1,13,15,7,8,16,39,24,0,Matches
Jonas Hofmann,de GER,MF,Leverkusen,31-166,1992,14.1,14,9,3,8,3,7,15,46.7,8,8,0,8,6,20,5,0,Matches
Philipp Hofmann,de GER,FW,Bochum,30-272,1993,8.7,8,3,2,5,1,4,6,66.7,2,3,0,3,1,9,12,0,Matches
Lucas Höler,de GER,"FW,MF",Freiburg,29-170,1994,13.0,19,13,9,6,4,2,8,25.0,6,9,1,8,9,28,15,0,Matches
Fabian Holland,de GER,"MF,DF",Darmstadt 98,33-169,1990,11.0,23,13,12,9,2,13,23,56.5,10,12,6,6,15,38,21,0,Matches
Benedict Hollerbach,de GER,"FW,MF",Union Berlin,22-224,2001,3.9,7,4,2,4,1,3,10,30.0,7,13,0,13,1,8,2,0,Matches
Franck Honorat,fr FRA,"DF,FW",M'Gladbach,27-138,1996,13.9,12,7,7,5,0,6,10,60.0,4,12,1,11,5,17,14,0,Matches
Mathias Honsak,at AUT,"MF,FW",Darmstadt 98,27-007,1996,6.6,6,4,3,2,1,4,10,40.0,6,7,1,6,3,9,12,0,Matches
Fraser Hornby,sct SCO,"FW,MF",Darmstadt 98,24-105,1999,2.4,0,0,0,0,0,0,1,0.0,1,2,1,1,0,0,4,0,Matches
Lukáš Hrádecký,fi FIN,GK,Leverkusen,34-033,1989,16.0,0,0,0,0,0,0,0,,0,1,0,1,0,0,4,2,Matches
Timo Hübers,de GER,DF,Köln,27-160,1996,15.9,37,30,29,6,2,25,46,54.3,21,32,18,14,37,74,87,0,Matches
Mats Hummels,de GER,DF,Dortmund,35-011,1988,11.0,31,21,16,9,6,18,33,54.5,15,21,5,16,25,56,53,0,Matches
Denis Huseinbasic,de GER,MF,Köln,22-177,2001,5.1,9,4,5,2,2,4,9,44.4,5,8,0,8,4,13,3,0,Matches
Iago,br BRA,"DF,FW",Augsburg,26-279,1997,5.7,14,7,8,5,1,8,16,50.0,8,8,1,7,4,18,11,0,Matches
Thomas Isherwood,se SWE,DF,Darmstadt 98,25-333,1998,3.6,7,3,3,3,1,4,5,80.0,1,3,2,1,5,12,16,0,Matches
Ko Itakura,jp JPN,DF,M'Gladbach,26-334,1997,6.8,12,7,6,6,0,6,11,54.5,5,15,7,8,12,24,22,0,Matches
Hiroki Ito,jp JPN,DF,Stuttgart,24-229,1999,10.9,4,4,3,1,0,3,8,37.5,5,11,5,6,16,20,30,0,Matches
Lee Jae-sung,kr KOR,MF,Mainz 05,31-139,1992,12.4,12,7,4,7,1,5,23,21.7,18,13,1,12,15,27,12,0,Matches
Paul Jaeckel,de GER,DF,Union Berlin,25-158,1998,2.4,7,2,4,3,0,5,8,62.5,3,2,1,1,4,11,5,0,Matches
Kristijan Jakić,hr CRO,MF,Eint Frankfurt,26-227,1997,2.0,1,1,0,1,0,0,2,0.0,2,1,0,1,1,2,2,0,Matches
Tony Jantschke,de GER,"DF,MF",M'Gladbach,33-264,1990,0.2,1,1,1,0,0,1,1,100.0,0,2,2,0,0,1,2,0,Matches
Fredrik Jensen,fi FIN,"FW,MF",Augsburg,26-109,1997,7.5,10,3,3,2,5,5,13,38.5,8,13,1,12,6,16,8,0,Matches
Moritz Jenz,de GER,DF,Wolfsburg,24-241,1999,8.5,10,7,4,5,1,4,6,66.7,2,12,8,4,13,23,47,0,Matches
Anthony Jung,de GER,"DF,FW",Werder Bremen,32-054,1991,13.4,18,9,12,5,1,8,16,50.0,8,16,7,9,11,29,46,0,Matches
Josip Juranović,hr CRO,DF,Union Berlin,28-133,1995,6.6,8,5,4,3,1,2,7,28.6,5,5,1,4,1,9,15,0,Matches
Julian Justvan,de GER,"FW,MF",Hoffenheim,25-269,1998,0.5,1,0,1,0,0,1,2,50.0,1,1,0,1,0,1,0,0,Matches
Ozan Kabak,tr TUR,DF,Hoffenheim,23-277,2000,10.7,19,15,12,5,2,9,13,69.2,4,14,6,8,15,34,39,1,Matches
Pavel Kadeřábek,cz CZE,"DF,FW",Hoffenheim,31-246,1992,11.0,13,8,4,8,1,9,17,52.9,8,10,4,6,12,25,25,0,Matches
Florian Kainz,at AUT,"MF,FW",Köln,31-064,1992,12.3,18,14,6,6,6,12,23,52.2,11,12,5,7,7,25,10,0,Matches
Jakub Kamiński,pl POL,"FW,MF",Wolfsburg,21-205,2002,1.8,3,2,3,0,0,1,3,33.3,2,2,0,2,0,3,2,0,Matches
Kevin Kampl,si SVN,MF,RB Leipzig,33-079,1990,9.5,13,7,5,6,2,6,13,46.2,7,13,5,8,8,21,8,1,Matches
Harry Kane,eng ENG,FW,Bayern Munich,30-152,1993,14.6,5,3,3,1,1,3,11,27.3,8,5,1,4,4,9,10,0,Matches
Atakan Karazor,de GER,MF,Stuttgart,27-075,1996,15.2,43,27,16,23,4,20,33,60.6,13,13,4,9,17,60,23,0,Matches
Emir Karic,at AUT,DF,Darmstadt 98,26-201,1997,7.3,20,15,10,5,5,12,15,80.0,3,15,1,14,7,27,15,0,Matches
Silas Katompa,cd COD,"FW,MF",Stuttgart,25-082,1998,8.1,3,2,2,1,0,2,7,28.6,5,8,0,8,0,3,3,0,Matches
Mikkel Kaufmann,dk DEN,"FW,DF",Union Berlin,22-358,2001,1.1,0,0,0,0,0,0,1,0.0,1,0,0,0,0,0,0,0,Matches
Naby Keïta,gn GUI,MF,Werder Bremen,28-320,1995,0.9,0,0,0,0,0,0,1,0.0,1,1,0,1,1,1,0,0,Matches
Yannik Keitel,de GER,MF,Freiburg,23-315,2000,1.4,7,5,3,3,1,3,4,75.0,1,3,0,3,4,11,4,1,Matches
Thomas Keller,de GER,"MF,FW",Heidenheim,24-144,1999,0.0,0,0,0,0,0,0,0,,0,0,0,0,0,0,0,0,Matches
Aljoscha Kemlein,de GER,MF,Union Berlin,19-147,2004,0.3,0,0,0,0,0,0,3,0.0,3,1,0,1,0,0,0,0,Matches
Tobias Kempe,de GER,MF,Darmstadt 98,34-183,1989,8.2,7,7,4,3,0,4,9,44.4,5,5,1,4,6,13,5,0,Matches
Rani Khedira,de GER,MF,Union Berlin,29-334,1994,4.0,9,5,4,5,0,4,6,66.7,2,3,0,3,5,14,10,0,Matches
Luca Kilian,de GER,DF,Köln,24-117,1999,3.1,10,5,9,1,0,5,7,71.4,2,7,3,4,1,11,8,0,Matches
Joshua Kimmich,de GER,MF,Bayern Munich,28-322,1995,9.5,22,16,8,10,4,12,18,66.7,6,11,2,9,9,31,5,1,Matches
Christoph Klarer,at AUT,DF,Darmstadt 98,23-196,2000,13.0,21,13,16,2,3,11,20,55.0,9,15,6,9,10,31,37,1,Matches
Tim Kleindienst,de GER,FW,Heidenheim,28-118,1995,15.5,8,6,2,4,2,3,11,27.3,8,11,4,7,5,13,23,0,Matches
Lukas Klostermann,de GER,DF,RB Leipzig,27-207,1996,8.7,10,7,5,4,1,4,11,36.4,7,11,4,7,4,14,35,0,Matches
Ansgar Knauff,de GER,"MF,FW",Eint Frankfurt,21-351,2002,8.9,22,13,10,8,4,9,17,52.9,8,14,2,12,6,28,6,0,Matches
Robin Knoche,de GER,DF,Union Berlin,31-219,1992,11.6,25,15,19,6,0,14,23,60.9,9,13,9,4,7,32,34,0,Matches
Gregor Kobel,ch SUI,GK,Dortmund,26-021,1997,15.3,0,0,0,0,0,0,0,,0,0,0,0,0,0,9,0,Matches
Robin Koch,de GER,DF,Eint Frankfurt,27-163,1996,13.7,16,11,11,5,0,9,11,81.8,2,17,12,5,15,31,64,0,Matches
Dominik Kohr,de GER,"MF,DF",Mainz 05,29-330,1994,11.4,31,20,19,10,2,15,28,53.6,13,12,4,8,24,55,27,0,Matches
Randal Kolo Muani,fr FRA,FW,Eint Frankfurt,25-022,1998,1.7,0,0,0,0,0,0,0,,0,0,0,0,0,0,1,0,Matches
Kouadio Koné,fr FRA,MF,M'Gladbach,22-224,2001,6.8,17,8,6,8,3,6,11,54.5,5,8,0,8,5,22,3,1,Matches
Odilon Kossonou,ci CIV,DF,Leverkusen,22-357,2001,13.4,22,16,9,9,4,8,13,61.5,5,21,2,19,23,45,28,0,Matches
Dawid Kownacki,pl POL,FW,Werder Bremen,26-288,1997,2.4,0,0,0,0,0,0,2,0.0,2,1,1,0,0,0,1,0,Matches
Alex Král,cz CZE,MF,Union Berlin,25-222,1998,8.5,12,8,2,8,2,4,11,36.4,7,9,2,7,2,14,14,0,Matches
Andrej Kramarić,hr CRO,"MF,FW",Hoffenheim,32-191,1991,10.3,3,1,2,0,1,2,5,40.0,3,5,0,5,2,5,6,0,Matches
Christoph Kramer,de GER,MF,M'Gladbach,32-311,1991,2.0,8,4,3,5,0,2,12,16.7,10,5,1,4,4,12,4,0,Matches
Frans Krätzig,de GER,DF,Bayern Munich,20-347,2003,0.6,2,0,2,0,0,1,2,50.0,1,0,0,0,0,2,0,0,Matches
Tom Krauß,de GER,MF,Mainz 05,22-188,2001,8.9,37,21,13,20,4,13,35,37.1,22,18,4,14,10,47,14,0,Matches
Lukas Kübler,de GER,DF,Freiburg,31-119,1992,9.5,20,10,14,5,1,11,17,64.7,6,14,8,6,13,33,21,0,Matches
Moritz-Broni Kwarteng,gh GHA,"FW,MF",Bochum,25-243,1998,1.8,1,0,0,1,0,0,3,0.0,3,0,0,0,1,2,0,0,Matches
Maxence Lacroix,fr FRA,DF,Wolfsburg,23-265,2000,13.2,23,13,15,8,0,15,21,71.4,6,20,8,12,16,39,69,0,Matches
Aïssa Laïdouni,tn TUN,MF,Union Berlin,27-014,1996,8.0,15,8,4,8,3,3,7,42.9,4,17,2,15,10,25,5,0,Matches
Konrad Laimer,at AUT,"DF,MF",Bayern Munich,26-214,1997,11.3,28,17,10,11,7,14,27,51.9,13,24,4,20,12,40,9,1,Matches
Hugo Larsson,se SWE,MF,Eint Frankfurt,19-183,2004,12.8,17,9,10,5,2,7,14,50.0,7,15,2,13,18,35,13,1,Matches
Diogo Leite,pt POR,DF,Union Berlin,24-338,1999,14.6,22,17,12,7,3,13,27,48.1,14,23,10,13,23,45,74,0,Matches
Maxim Leitsch,de GER,DF,Mainz 05,25-223,1998,4.1,5,2,4,1,0,2,5,40.0,3,2,0,2,4,9,12,0,Matches
Christopher Lenz,de GER,"DF,MF",RB Leipzig,29-096,1994,0.4,1,1,1,0,0,1,1,100.0,0,0,0,0,1,2,2,0,Matches
Christopher Lenz,de GER,DF,Eint Frankfurt,29-096,1994,0.1,1,1,0,1,0,1,1,100.0,0,0,0,0,0,1,1,0,Matches
Jamie Leweling,de GER,"MF,FW",Stuttgart,22-304,2001,6.1,8,4,3,2,3,2,6,33.3,4,10,0,10,1,9,5,0,Matches
Philipp Lienhart,at AUT,DF,Freiburg,27-169,1996,13.7,18,12,12,5,1,11,20,55.0,9,17,10,7,13,31,50,0,Matches
Matthijs de Ligt,nl NED,DF,Bayern Munich,24-137,1999,3.1,3,3,0,2,1,2,2,100.0,0,2,1,1,3,6,15,0,Matches
Jesper Lindstrøm,dk DEN,FW,Eint Frankfurt,23-301,2000,0.9,1,1,1,0,0,0,0,,0,0,0,0,0,1,0,0,Matches
Dejan Ljubicic,at AUT,"MF,FW",Köln,26-080,1997,12.3,26,16,12,10,4,13,24,54.2,11,14,2,12,10,36,4,0,Matches
Noah Loosli,ch SUI,"DF,MF",Bochum,26-338,1997,1.8,6,5,4,2,0,5,6,83.3,1,2,0,2,2,8,12,0,Matches
Anthony Losilla,fr FRA,MF,Bochum,37-292,1986,13.5,33,16,7,23,3,13,23,56.5,10,20,5,15,16,49,21,0,Matches
Castello Lukeba,fr FRA,DF,RB Leipzig,21-010,2002,11.0,10,6,5,5,0,6,8,75.0,2,21,7,14,5,15,40,1,Matches
Senne Lynen,be BEL,MF,Werder Bremen,24-311,1999,4.9,10,6,3,6,1,4,14,28.6,10,14,1,13,14,24,10,0,Matches
Matej Maglica,hr CRO,DF,Darmstadt 98,25-093,1998,8.2,16,9,11,5,0,11,17,64.7,6,15,5,10,12,28,44,1,Matches
Arne Maier,de GER,"DF,MF",Augsburg,24-353,1999,0.7,2,2,0,1,1,1,2,50.0,1,1,0,1,0,2,0,0,Matches
Linton Maina,de GER,"FW,MF",Köln,24-187,1999,11.0,10,9,7,1,2,6,19,31.6,13,7,1,6,4,14,4,0,Matches
Patrick Mainka,de GER,DF,Heidenheim,29-051,1994,16.0,30,15,21,8,1,14,31,45.2,17,31,13,18,23,53,74,0,Matches
Lovro Majer,hr CRO,"MF,FW",Wolfsburg,25-344,1998,12.5,17,9,7,10,0,5,16,31.3,11,11,1,10,4,21,7,0,Matches
Jordy Makengo,fr FRA,DF,Freiburg,22-146,2001,3.4,7,4,4,2,1,4,6,66.7,2,5,0,5,5,12,15,0,Matches
Donyell Malen,nl NED,"FW,MF",Dortmund,24-352,1999,10.6,5,5,2,1,2,0,2,0.0,2,5,1,4,2,7,5,0,Matches
Lennard Maloney,us USA,MF,Heidenheim,24-080,1999,14.8,20,13,9,8,3,13,32,40.6,19,14,2,12,19,39,56,0,Matches
David Mamutovic,de GER,DF,Mainz 05,23-022,2000,0.1,1,1,0,1,0,1,1,100.0,0,0,0,0,0,1,0,0,Matches
Braydon Manu,gh GHA,MF,Darmstadt 98,26-274,1997,0.9,1,0,0,1,0,0,0,,0,1,0,1,0,1,0,0,Matches
Omar Marmoush,eg EGY,"FW,MF",Eint Frankfurt,24-323,1999,12.0,11,5,5,4,2,5,9,55.6,4,4,0,4,6,17,6,0,Matches
Eric Martel,de GER,MF,Köln,21-242,2002,12.4,37,23,17,18,2,22,37,59.5,15,28,8,20,18,55,35,0,Matches
Erhan Mašović,rs SRB,DF,Bochum,25-035,1998,12.4,38,22,23,12,3,22,38,57.9,16,17,8,9,11,49,30,1,Matches
Roberto Massimo,de GER,"DF,FW",Stuttgart,23-076,2000,0.7,1,0,1,0,0,1,2,50.0,1,0,0,0,0,1,1,0,Matches
Philipp Max,de GER,"DF,MF",Eint Frankfurt,30-088,1993,9.3,16,9,4,10,2,14,20,70.0,6,13,1,12,4,20,9,0,Matches
Eric Maxim Choupo-Moting,cm CMR,"MF,FW",Bayern Munich,34-279,1989,3.7,8,6,3,4,1,2,3,66.7,1,1,0,1,2,10,3,0,Matches
Noussair Mazraoui,ma MAR,DF,Bayern Munich,26-043,1997,9.1,12,8,5,5,2,5,10,50.0,5,9,1,8,13,25,16,1,Matches
Kevin Mbabu,ch SUI,DF,Augsburg,28-252,1995,7.9,19,14,11,5,3,9,12,75.0,3,10,4,6,10,29,14,0,Matches
Noah Mbamba,be BEL,MF,Leverkusen,18-356,2005,0.2,0,0,0,0,0,0,0,,0,0,0,0,1,1,0,0,Matches
Nathanael Mbuku,fr FRA,FW,Augsburg,21-286,2002,0.1,0,0,0,0,0,0,0,,0,1,0,1,0,0,0,0,Matches
Marvin Mehlem,de GER,MF,Darmstadt 98,26-107,1997,10.8,18,13,6,8,4,8,20,40.0,12,16,2,14,24,42,13,0,Matches
Thomas Meunier,be BEL,DF,Dortmund,32-106,1991,2.9,3,1,2,1,0,1,10,10.0,9,2,0,2,2,5,6,0,Matches
Alexander Meyer,de GER,GK,Dortmund,32-258,1991,0.7,1,1,1,0,0,1,1,100.0,0,0,0,0,0,1,1,0,Matches
Sven Michel,de GER,"FW,MF",Augsburg,33-165,1990,4.8,5,3,1,1,3,2,5,40.0,3,1,0,1,0,5,4,0,Matches
Enzo Millot,fr FRA,"MF,FW",Stuttgart,21-163,2002,11.4,20,12,5,10,5,9,16,56.3,7,9,1,8,6,26,4,1,Matches
Jovan Milošević,rs SRB,FW,Stuttgart,18-149,2005,0.3,0,0,0,0,0,0,0,,0,0,0,0,0,0,0,0,Matches
Kim Min-jae,kr KOR,DF,Bayern Munich,27-042,1996,14.6,16,9,9,4,3,7,16,43.8,9,19,9,10,31,47,47,1,Matches
Maximilian Mittelstädt,de GER,DF,Stuttgart,26-284,1997,7.8,36,21,21,11,4,24,35,68.6,11,15,3,12,22,58,16,0,Matches
Youssoufa Moukoko,de GER,FW,Dortmund,19-037,2004,1.7,2,0,2,0,0,1,2,50.0,1,2,1,1,1,3,0,0,Matches
Andreas Müller,de GER,MF,Darmstadt 98,23-160,2000,0.6,5,5,2,3,0,2,2,100.0,0,1,1,0,1,6,3,0,Matches
Jannik Müller,de GER,DF,Darmstadt 98,29-343,1994,6.7,11,4,9,2,0,6,9,66.7,3,9,6,3,9,20,25,0,Matches
Kevin Müller,de GER,GK,Heidenheim,32-287,1991,16.0,1,0,1,0,0,1,1,100.0,0,0,0,0,0,1,4,1,Matches
Marcus Müller,de GER,MF,Mainz 05,21-129,2002,0.2,0,0,0,0,0,0,0,,0,0,0,0,0,0,0,0,Matches
Thomas Müller,de GER,MF,Bayern Munich,34-105,1989,5.6,10,8,1,3,6,6,14,42.9,8,9,0,9,0,10,2,0,Matches
Jamal Musiala,de GER,"MF,FW",Bayern Munich,20-304,2003,7.2,19,14,5,13,1,9,16,56.3,7,13,1,12,5,24,2,0,Matches
Phillipp Mwene,at AUT,DF,Mainz 05,29-332,1994,8.4,13,5,5,6,2,7,13,53.8,6,11,0,11,10,23,14,0,Matches
Joakim Mæhle,dk DEN,DF,Wolfsburg,26-221,1997,14.0,33,19,18,9,6,22,36,61.1,14,21,2,19,16,49,37,0,Matches
Nathan N'Goumou,fr FRA,"FW,MF",M'Gladbach,23-288,2000,7.4,16,12,9,6,1,8,18,44.4,10,11,0,11,2,18,9,0,Matches
Stanley N'Soki,fr FRA,DF,Hoffenheim,24-262,1999,0.3,1,0,0,1,0,1,2,50.0,1,0,0,0,0,1,6,0,Matches
Luca Netz,de GER,DF,M'Gladbach,20-226,2003,12.5,24,14,10,11,3,12,21,57.1,9,21,7,14,11,35,51,1,Matches
Manuel Neuer,de GER,GK,Bayern Munich,37-275,1986,7.0,0,0,0,0,0,0,0,,0,0,0,0,0,0,1,0,Matches
Florian Neuhaus,de GER,MF,M'Gladbach,26-286,1997,6.7,5,5,2,3,0,3,14,21.4,11,5,4,1,7,12,6,0,Matches
Jessic Ngankam,de GER,"FW,DF",Eint Frankfurt,23-160,2000,2.8,2,1,0,1,1,0,0,,0,0,0,0,0,2,1,0,Matches
Moritz Nicolas,de GER,GK,M'Gladbach,26-067,1997,14.0,1,0,1,0,0,1,2,50.0,1,0,0,0,0,1,5,1,Matches
Justin Njinmah,de GER,"FW,MF",Werder Bremen,23-042,2000,4.0,3,0,1,2,0,2,5,40.0,3,3,0,3,2,5,4,0,Matches
Niels Nkounkou,fr FRA,"DF,MF",Eint Frankfurt,23-056,2000,4.6,13,8,6,7,0,7,17,41.2,10,14,0,14,7,20,7,0,Matches
Felix Nmecha,de GER,MF,Dortmund,23-078,2000,6.7,13,9,3,6,4,8,13,61.5,5,9,0,9,8,21,11,0,Matches
Alexander Nübel,de GER,GK,Stuttgart,27-088,1996,16.0,1,1,1,0,0,1,2,50.0,1,0,0,0,0,1,6,1,Matches
Fabian Nürnberger,de GER,"DF,MF",Darmstadt 98,24-152,1999,10.6,19,14,16,3,0,17,33,51.5,16,5,1,4,11,30,19,0,Matches
Tim Oermann,de GER,"DF,MF",Bochum,20-082,2003,1.1,3,2,2,0,1,1,1,100.0,0,2,1,1,0,3,1,0,Matches
Masaya Okugawa,jp JPN,"FW,DF",Augsburg,27-257,1996,0.4,0,0,0,0,0,0,0,,0,0,0,0,0,0,2,0,Matches
Finn Ole Becker,de GER,MF,Hoffenheim,23-202,2000,3.8,6,6,4,2,0,2,8,25.0,6,8,1,7,0,6,3,0,Matches
Mathias Olesen,lu LUX,"MF,FW",Köln,22-281,2001,1.2,0,0,0,0,0,0,0,,0,0,0,0,2,2,2,0,Matches
Dani Olmo,es ESP,"MF,FW",RB Leipzig,25-234,1998,3.1,2,0,1,1,0,1,2,50.0,1,1,0,1,3,5,2,0,Matches
Jonas Omlin,ch SUI,GK,M'Gladbach,29-351,1994,2.0,0,0,0,0,0,0,0,,0,0,0,0,0,0,1,0,Matches
Karim Onisiwo,at AUT,"FW,MF",Mainz 05,31-285,1992,8.9,10,5,1,5,4,3,6,50.0,3,12,3,9,1,11,1,0,Matches
Loïs Openda,be BEL,FW,RB Leipzig,23-314,2000,13.9,2,2,0,0,2,0,2,0.0,2,5,0,5,2,4,6,0,Matches
Leon Opitz,de GER,"FW,DF",Werder Bremen,18-260,2005,0.2,2,2,1,1,0,2,3,66.7,1,0,0,0,0,2,0,0,Matches
Willi Orban,hu HUN,DF,RB Leipzig,31-054,1992,3.0,7,4,2,5,0,4,5,80.0,1,4,1,3,2,9,14,0,Matches
Ivan Ordets,ua UKR,DF,Bochum,31-172,1992,8.4,4,2,0,3,1,1,2,50.0,1,14,8,6,19,23,42,0,Matches
Patrick Osterhage,de GER,"MF,DF",Bochum,23-329,2000,8.6,14,10,2,11,1,3,12,25.0,9,11,0,11,10,24,14,0,Matches
Salih Özcan,tr TUR,MF,Dortmund,25-350,1998,6.1,11,5,7,4,0,5,8,62.5,3,12,1,11,6,17,4,0,Matches
Willian Pacho,ec ECU,DF,Eint Frankfurt,22-072,2001,16.0,40,27,24,15,1,19,26,73.1,7,22,6,16,25,65,74,0,Matches
Gonçalo Paciência,pt POR,FW,Bochum,29-148,1994,4.6,5,2,1,2,2,3,5,60.0,2,1,0,1,0,5,4,0,Matches
Exequiel Palacios,ar ARG,MF,Leverkusen,25-083,1998,13.4,37,21,14,18,5,14,31,45.2,17,18,0,18,24,61,12,2,Matches
Miloš Pantović,rs SRB,MF,Union Berlin,27-173,1996,0.2,0,0,0,0,0,0,0,,0,0,0,0,0,0,0,0,Matches
Antonios Papadopoulos,de GER,DF,Dortmund,24-108,1999,0.3,3,1,3,0,0,3,3,100.0,0,1,0,1,0,3,4,0,Matches
Matondo-Merveille Papela,de GER,"MF,DF",Mainz 05,22-343,2001,1.6,1,1,0,1,0,0,2,0.0,2,0,0,0,3,4,1,0,Matches
Leart Paqarada,xk KVX,DF,Köln,29-080,1994,9.6,17,9,8,8,1,8,19,42.1,11,15,5,10,9,26,20,1,Matches
Kevin Paredes,us USA,"MF,FW",Wolfsburg,20-234,2003,3.9,11,4,7,4,0,6,11,54.5,5,10,0,10,11,22,5,0,Matches
Felix Passlack,de GER,DF,Bochum,25-212,1998,4.8,10,7,4,5,1,7,13,53.8,6,6,1,5,5,15,10,0,Matches
Jiří Pavlenka,cz CZE,GK,Werder Bremen,31-257,1992,7.0,0,0,0,0,0,0,0,,0,0,0,0,0,0,2,0,Matches
Aleksandar Pavlovic,de GER,MF,Bayern Munich,19-238,2004,3.3,12,10,5,6,1,7,11,63.6,4,6,0,6,2,14,3,0,Matches
Mads Pedersen,dk DEN,DF,Augsburg,27-117,1996,12.4,29,19,13,13,3,9,20,45.0,11,12,2,10,11,40,28,0,Matches
Jordan Pefok,us USA,FW,M'Gladbach,27-245,1996,5.5,2,1,0,2,0,0,2,0.0,2,6,2,4,1,3,9,0,Matches
Jordan Pefok,us USA,FW,Union Berlin,27-245,1996,0.3,0,0,0,0,0,0,0,,0,1,1,0,0,0,0,0,Matches
Pavao Pervan,at AUT,GK,Wolfsburg,36-044,1987,3.0,0,0,0,0,0,0,0,,0,0,0,0,0,0,1,0,Matches
Jens Petter Hauge,no NOR,"MF,FW",Eint Frankfurt,24-076,1999,1.5,2,1,1,0,1,2,6,33.3,4,5,1,4,0,2,0,0,Matches
Luca Pfeiffer,de GER,"FW,MF",Darmstadt 98,27-129,1996,11.2,7,3,0,4,3,3,7,42.9,4,3,1,2,2,9,11,0,Matches
Patric Pfeiffer,de GER,DF,Augsburg,24-129,1999,4.1,9,5,5,3,1,5,6,83.3,1,7,4,3,8,17,16,0,Matches
Maximilian Philipp,de GER,"FW,MF",Freiburg,29-301,1994,2.5,7,5,4,3,0,1,5,20.0,4,5,0,5,0,7,0,0,Matches
Florian Pick,de GER,"MF,FW",Heidenheim,28-110,1995,2.4,3,3,2,0,1,2,3,66.7,1,2,0,2,2,5,1,0,Matches
Amos Pieper,de GER,DF,Werder Bremen,25-344,1998,6.0,13,10,8,5,0,7,12,58.3,5,12,7,5,8,21,34,1,Matches
Marvin Pieringer,de GER,"FW,MF",Heidenheim,24-084,1999,8.1,10,8,3,5,2,4,10,40.0,6,17,3,14,8,18,11,0,Matches
Alassane Pléa,fr FRA,"FW,MF",M'Gladbach,30-292,1993,13.0,11,6,4,5,2,4,11,36.4,7,6,0,6,0,11,3,0,Matches
Yussuf Poulsen,dk DEN,FW,RB Leipzig,29-195,1994,9.4,8,6,0,5,3,2,7,28.6,5,8,1,7,3,11,11,0,Matches
Grischa Prömel,de GER,MF,Hoffenheim,28-352,1995,13.6,22,15,6,10,6,10,24,41.7,14,13,3,10,9,31,23,0,Matches
Gustavo Puerta,co COL,"DF,MF",Leverkusen,20-157,2003,0.3,5,3,2,2,1,1,1,100.0,0,2,0,2,0,5,0,0,Matches
Luca Raimund,de GER,FW,Stuttgart,18-262,2005,0.2,3,1,2,1,0,0,0,,0,1,0,1,0,3,0,0,Matches
Grant Ranos,am ARM,"FW,MF",M'Gladbach,20-160,2003,0.5,0,0,0,0,0,0,0,,0,0,0,0,0,0,0,0,Matches
Nicolai Rapp,de GER,DF,Werder Bremen,27-014,1996,0.8,3,2,2,1,0,2,2,100.0,0,2,0,2,2,5,8,0,Matches
David Raum,de GER,DF,RB Leipzig,25-249,1998,15.7,26,15,12,11,3,17,30,56.7,13,26,4,22,8,34,33,2,Matches
Rocco Reitz,de GER,MF,M'Gladbach,21-212,2002,12.3,28,18,11,15,2,14,27,51.9,13,25,9,16,14,42,22,0,Matches
Marco Reus,de GER,"MF,FW",Dortmund,34-210,1989,9.9,20,17,8,10,2,5,11,45.5,6,9,0,9,4,24,11,0,Matches
Elvis Rexhbeçaj,de GER,MF,Augsburg,26-056,1997,15.3,21,14,6,12,3,13,24,54.2,11,23,4,19,14,35,12,0,Matches
Gio Reyna,us USA,"MF,FW",Dortmund,21-044,2002,2.6,9,6,3,4,2,2,5,40.0,3,5,1,4,2,11,4,0,Matches
Marco Richter,de GER,"MF,FW",Mainz 05,26-033,1997,5.8,5,1,2,2,1,1,5,20.0,4,6,0,6,1,6,1,0,Matches
Clemens Riedel,de GER,DF,Darmstadt 98,20-161,2003,4.1,10,6,8,1,1,6,11,54.5,5,7,2,5,8,18,17,0,Matches
Manuel Riemann,de GER,GK,Bochum,35-109,1988,16.0,1,0,1,0,0,1,1,100.0,0,0,0,0,1,2,11,0,Matches
Sebastian Rode,de GER,MF,Eint Frankfurt,33-077,1990,0.3,3,2,0,2,1,2,3,66.7,1,0,0,0,1,4,0,0,Matches
Rogério,br BRA,"DF,MF",Wolfsburg,25-348,1998,5.8,4,2,4,0,0,2,5,40.0,3,9,3,6,3,7,9,1,Matches
Merlin Röhl,de GER,"MF,FW",Freiburg,21-175,2002,8.5,13,8,7,4,2,3,12,25.0,9,16,2,14,1,14,15,0,Matches
Frank Ronstadt,de GER,"DF,MF",Darmstadt 98,26-159,1997,0.8,1,0,0,1,0,0,1,0.0,1,1,0,1,1,2,3,0,Matches
Anthony Rouault,fr FRA,DF,Stuttgart,22-212,2001,5.1,12,8,9,3,0,8,10,80.0,2,8,4,4,3,15,11,0,Matches
Jérôme Roussillon,fr FRA,DF,Union Berlin,30-355,1993,5.3,8,4,3,3,2,3,6,50.0,3,8,3,5,4,12,14,0,Matches
Fabian Rüdlin,de GER,MF,Freiburg,26-348,1997,0.1,1,0,0,0,1,0,0,,0,0,0,0,0,1,0,0,Matches
Julian Ryerson,no NOR,DF,Dortmund,26-040,1997,9.9,22,15,15,5,2,17,24,70.8,7,16,2,14,6,28,20,2,Matches
Frederik Rønnow,dk DEN,GK,Union Berlin,31-145,1992,15.0,0,0,0,0,0,0,0,,0,0,0,0,1,1,11,1,Matches
Marcel Sabitzer,at AUT,MF,Dortmund,29-285,1994,9.3,15,9,8,7,0,10,21,47.6,11,16,6,10,6,21,19,0,Matches
Roland Sallai,hu HUN,"FW,DF",Freiburg,26-219,1997,8.4,6,2,4,0,2,3,9,33.3,6,13,1,12,3,9,14,0,Matches
Diadie Samassékou,ml MLI,MF,Hoffenheim,27-350,1996,0.0,0,0,0,0,0,0,0,,0,0,0,0,1,1,0,0,Matches
Leroy Sané,de GER,FW,Bayern Munich,27-350,1996,14.6,10,5,4,4,2,4,11,36.4,7,9,0,9,3,13,2,0,Matches
Amin Sarr,se SWE,"FW,MF",Wolfsburg,22-291,2001,1.1,0,0,0,0,0,0,0,,0,1,1,0,0,0,0,0,Matches
Bouna Sarr,sn SEN,DF,Bayern Munich,31-330,1992,1.2,2,0,1,1,0,2,2,100.0,0,3,0,3,0,2,1,0,Matches
Joe Scally,us USA,DF,M'Gladbach,20-361,2002,12.9,27,18,12,13,2,16,23,69.6,7,17,6,11,12,39,43,1,Matches
András Schäfer,hu HUN,MF,Union Berlin,24-258,1999,1.9,2,1,0,2,0,1,3,33.3,2,1,0,1,3,5,1,0,Matches
Patrik Schick,cz CZE,"FW,MF",Leverkusen,27-337,1996,1.3,1,1,0,0,1,0,0,,0,1,0,1,0,1,1,0,Matches
Stefan Schimmer,de GER,"MF,FW",Heidenheim,29-243,1994,0.8,1,1,0,1,0,0,3,0.0,3,1,0,1,1,2,4,0,Matches
Xaver Schlager,at AUT,MF,RB Leipzig,26-090,1997,13.7,38,24,17,19,2,11,27,40.7,16,21,4,17,10,48,9,0,Matches
Keven Schlotterbeck,de GER,DF,Bochum,26-243,1997,9.0,14,8,11,2,1,7,8,87.5,1,15,11,4,12,26,39,0,Matches
Nico Schlotterbeck,de GER,DF,Dortmund,24-026,1999,14.5,27,19,15,11,1,15,28,53.6,13,23,13,10,16,43,49,2,Matches
Romano Schmid,at AUT,MF,Werder Bremen,23-334,2000,13.6,19,12,5,12,2,10,26,38.5,16,17,1,16,3,22,9,2,Matches
Kenneth Schmidt,de GER,DF,Freiburg,21-207,2002,0.8,2,2,2,0,0,2,4,50.0,2,1,0,1,1,3,2,0,Matches
Benno Schmitz,de GER,DF,Köln,29-040,1994,6.0,13,7,11,2,0,9,18,50.0,9,10,2,8,2,15,14,0,Matches
Fabian Schnellhardt,de GER,MF,Darmstadt 98,29-349,1994,2.3,4,1,2,1,1,1,3,33.3,2,1,0,1,4,8,5,0,Matches
Jan Schöppner,de GER,MF,Heidenheim,24-198,1999,7.0,9,2,5,4,0,6,13,46.2,7,8,2,6,9,18,18,0,Matches
Marcel Schuhen,de GER,GK,Darmstadt 98,30-348,1993,15.0,0,0,0,0,0,0,1,0.0,1,0,0,0,0,0,5,3,Matches
Marvin Schwäbe,de GER,GK,Köln,28-246,1995,16.0,1,0,1,0,0,1,1,100.0,0,0,0,0,0,1,7,0,Matches
Nicolas Seiwald,at AUT,MF,RB Leipzig,22-237,2001,1.6,11,7,7,3,1,5,7,71.4,2,4,1,3,1,12,0,0,Matches
Davie Selke,de GER,FW,Köln,28-341,1995,11.3,3,2,1,2,0,0,1,0.0,1,3,2,1,0,3,15,0,Matches
Benjamin Šeško,si SVN,FW,RB Leipzig,20-210,2003,3.9,5,2,2,3,0,1,3,33.3,2,9,1,8,1,6,5,0,Matches
Kevin Sessa,de GER,"MF,FW",Heidenheim,23-174,2000,2.4,1,1,0,0,1,0,4,0.0,4,5,0,5,1,2,4,0,Matches
Aaron Seydel,de GER,FW,Darmstadt 98,27-323,1996,2.9,2,1,0,2,0,0,0,,0,5,2,3,0,2,5,0,Matches
Tim Siersleben,de GER,DF,Heidenheim,23-293,2000,9.0,25,9,19,6,0,8,19,42.1,11,15,10,5,17,42,24,1,Matches
Kiliann Sildillia,fr FRA,DF,Freiburg,21-225,2002,11.5,23,9,15,5,3,16,26,61.5,10,14,5,9,12,35,29,0,Matches
Mohamed Simakan,fr FRA,DF,RB Leipzig,23-238,2000,14.8,25,16,16,9,0,17,25,68.0,8,22,9,13,21,46,45,0,Matches
Xavi Simons,nl NED,MF,RB Leipzig,20-250,2003,14.1,11,4,5,5,1,8,14,57.1,6,13,0,13,4,15,1,0,Matches
Tim Skarke,de GER,"FW,DF",Darmstadt 98,27-111,1996,12.0,12,9,8,2,2,7,13,53.8,6,12,1,11,5,17,10,0,Matches
Ellyes Skhiri,tn TUN,MF,Eint Frankfurt,28-231,1995,13.3,28,16,10,15,3,12,23,52.2,11,21,2,19,18,46,28,1,Matches
Robert Skov,dk DEN,"DF,FW",Hoffenheim,27-221,1996,9.1,16,9,10,5,1,10,23,43.5,13,14,2,12,7,23,14,1,Matches
Hrvoje Smolčić,hr CRO,DF,Eint Frankfurt,23-132,2000,2.8,6,2,6,0,0,4,5,80.0,1,2,0,2,3,9,19,0,Matches
Danilo Soares,br BRA,DF,Bochum,32-059,1991,3.9,10,6,5,3,2,5,8,62.5,3,6,0,6,7,17,11,0,Matches
Borna Sosa,hr CRO,"FW,DF",Stuttgart,25-340,1998,0.5,0,0,0,0,0,0,1,0.0,1,0,0,0,0,0,0,0,Matches
Anton Stach,de GER,MF,Hoffenheim,25-042,1998,11.5,34,18,21,11,2,15,28,53.6,13,12,4,8,39,73,27,0,Matches
Anton Stach,de GER,MF,Mainz 05,25-042,1998,1.9,3,0,2,0,1,2,4,50.0,2,5,0,5,2,5,5,0,Matches
Jens Stage,dk DEN,MF,Werder Bremen,27-049,1996,15.0,31,13,15,13,3,10,27,37.0,17,22,11,11,15,46,22,0,Matches
Josip Stanišić,hr CRO,DF,Leverkusen,23-269,2000,2.8,5,3,4,1,0,2,3,66.7,1,4,1,3,3,8,6,0,Matches
Niklas Stark,de GER,DF,Werder Bremen,28-257,1995,6.4,17,9,7,8,2,7,10,70.0,3,8,5,3,8,25,31,1,Matches
Pascal Stenzel,de GER,DF,Stuttgart,27-282,1996,8.4,13,7,5,7,1,9,24,37.5,15,15,6,9,13,26,20,0,Matches
Leonidas Stergiou,ch SUI,DF,Stuttgart,21-299,2002,0.5,5,3,2,3,0,3,3,100.0,0,1,0,1,1,6,1,0,Matches
Angelo Stiller,de GER,MF,Hoffenheim,22-267,2001,0.9,0,0,0,0,0,0,1,0.0,1,2,0,2,0,0,3,0,Matches
Angelo Stiller,de GER,MF,Stuttgart,22-267,2001,13.2,27,18,9,17,1,13,25,52.0,12,19,7,12,16,43,9,1,Matches
Kevin Stöger,at AUT,MF,Bochum,30-122,1993,13.2,25,17,11,11,3,14,38,36.8,24,15,1,14,12,37,6,0,Matches
Filip Stojilković,ch SUI,"FW,MF",Darmstadt 98,23-357,2000,1.7,1,1,0,0,1,0,0,,0,0,0,0,0,1,1,0,Matches
Niklas Süle,de GER,DF,Dortmund,28-115,1995,6.9,4,4,3,1,0,2,4,50.0,2,15,8,7,7,11,24,2,Matches
Mattias Svanberg,se SWE,MF,Wolfsburg,24-356,1999,13.4,29,13,6,14,9,8,27,29.6,19,17,4,13,13,42,19,0,Matches
Attila Szalai,hu HUN,DF,Hoffenheim,25-341,1998,3.2,3,1,3,0,0,1,4,25.0,3,6,2,4,1,4,7,0,Matches
Jonathan Tah,de GER,DF,Leverkusen,27-319,1996,14.5,14,7,8,5,1,4,11,36.4,7,18,15,3,7,21,61,1,Matches
Edmond Tapsoba,bf BFA,DF,Leverkusen,24-328,1999,13.0,17,13,7,9,1,6,9,66.7,3,8,5,3,8,25,35,2,Matches
Mathys Tel,fr FRA,"FW,MF",Bayern Munich,18-244,2005,2.4,2,0,0,1,1,0,0,,0,4,0,4,2,4,2,0,Matches
Nathan Tella,ng NGA,DF,Leverkusen,24-175,1999,0.9,0,0,0,0,0,0,0,,0,2,0,2,1,1,1,0,Matches
Norman Theuerkauf,de GER,"MF,DF",Heidenheim,36-337,1987,8.1,15,8,9,4,2,9,14,64.3,5,10,4,6,10,25,12,0,Matches
Jan Thielmann,de GER,"FW,MF",Köln,21-215,2002,4.9,12,8,8,3,1,4,7,57.1,3,17,2,15,4,16,10,0,Matches
Denis Thomalla,de GER,"MF,FW",Heidenheim,31-133,1992,3.9,6,4,2,4,0,5,9,55.6,4,2,1,1,3,9,8,0,Matches
Phillip Tietz,de GER,FW,Augsburg,26-171,1997,11.7,7,4,4,2,1,2,7,28.6,5,8,1,7,3,10,18,0,Matches
Steffen Tigges,de GER,"FW,MF",Köln,25-149,1998,4.1,2,1,1,0,1,0,0,,0,2,1,1,1,3,4,0,Matches
Umut Tohumcu,de GER,MF,Hoffenheim,19-138,2004,2.3,3,3,3,0,0,3,7,42.9,4,7,1,6,1,4,3,0,Matches
Tiago Tomás,pt POR,"FW,MF",Wolfsburg,21-194,2002,6.5,3,1,2,0,1,1,5,20.0,4,9,0,9,1,4,5,0,Matches
Fabio Torsiello,it ITA,"DF,FW",Darmstadt 98,18-328,2005,0.3,0,0,0,0,0,0,3,0.0,3,1,0,1,0,0,0,0,Matches
Lucas Tousart,fr FRA,MF,Union Berlin,26-242,1997,3.4,6,5,2,3,1,3,4,75.0,1,3,2,1,2,8,7,0,Matches
Omar Traoré,de GER,DF,Heidenheim,25-326,1998,12.6,23,12,15,4,4,12,22,54.5,10,14,3,11,18,41,21,0,Matches
Kevin Trapp,de GER,GK,Eint Frankfurt,33-172,1990,15.0,0,0,0,0,0,0,0,,0,0,0,0,1,1,8,1,Matches
Christopher Trimmel,at AUT,"DF,MF",Union Berlin,36-306,1987,8.3,7,5,2,5,0,3,10,30.0,7,4,1,3,8,15,22,0,Matches
Tuta,br BRA,DF,Eint Frankfurt,24-176,1999,14.0,34,19,20,10,4,24,33,72.7,9,9,5,4,15,49,51,0,Matches
Lukas Ullrich,de GER,DF,M'Gladbach,19-286,2004,0.2,1,0,1,0,0,1,3,33.3,2,0,0,0,0,1,1,0,Matches
Sven Ulreich,de GER,GK,Bayern Munich,35-146,1988,8.0,1,0,1,0,0,1,1,100.0,0,0,0,0,0,1,3,2,Matches
Deniz Undav,de GER,FW,Stuttgart,27-161,1996,8.7,8,1,3,2,3,2,7,28.6,5,5,0,5,4,12,3,0,Matches
Dayot Upamecano,fr FRA,DF,Bayern Munich,25-061,1998,11.7,21,12,12,9,0,11,20,55.0,9,9,4,5,8,29,32,1,Matches
Mark Uth,de GER,"MF,FW",Köln,32-125,1991,2.9,6,3,2,3,1,2,9,22.2,7,5,0,5,1,7,1,0,Matches
Josha Vagnoman,de GER,"DF,MF",Stuttgart,23-016,2000,2.9,5,2,2,3,0,3,10,30.0,7,4,2,2,1,6,4,0,Matches
Ruben Vargas,ch SUI,"MF,FW",Augsburg,25-144,1998,8.1,6,3,2,3,1,3,8,37.5,5,10,3,7,3,9,10,0,Matches
Miloš Veljković,rs SRB,DF,Werder Bremen,28-092,1995,12.2,18,9,9,8,1,11,20,55.0,9,15,10,5,5,23,30,0,Matches
Oscar Vilhelmsson,se SWE,"FW,MF",Darmstadt 98,20-086,2003,4.9,7,3,0,4,3,3,3,100.0,0,7,2,5,1,8,4,0,Matches
Kevin Vogt,de GER,DF,Hoffenheim,32-095,1991,14.7,14,10,7,7,0,8,13,61.5,5,16,13,3,9,23,54,0,Matches
Kevin Volland,de GER,"MF,FW",Union Berlin,31-150,1992,5.5,12,5,3,3,6,3,9,33.3,6,3,0,3,3,15,3,0,Matches
Aster Vranckx,be BEL,MF,Wolfsburg,21-084,2002,7.1,20,10,8,6,6,11,17,64.7,6,7,4,3,9,29,15,0,Matches
Luca Waldschmidt,de GER,"MF,FW",Köln,27-222,1996,9.4,16,9,2,11,3,5,14,35.7,9,14,3,11,5,21,8,0,Matches
Wout Weghorst,nl NED,FW,Hoffenheim,31-142,1992,10.8,8,5,3,4,1,5,7,71.4,2,14,4,10,1,9,13,0,Matches
Julian Weigl,de GER,MF,M'Gladbach,28-110,1995,14.9,30,21,14,14,2,17,29,58.6,12,20,4,16,16,46,27,1,Matches
Nelson Weiper,de GER,"FW,MF",Mainz 05,18-285,2005,1.2,1,0,1,0,0,1,2,50.0,1,1,0,1,1,2,0,0,Matches
Mitchell Weiser,de GER,"DF,FW",Werder Bremen,29-250,1994,15.4,37,21,18,16,3,17,28,60.7,11,20,3,17,4,41,18,0,Matches
Noah Weißhaupt,de GER,"DF,MF",Freiburg,22-098,2001,5.0,2,0,0,0,2,1,5,20.0,4,7,0,7,6,8,5,0,Matches
Timo Werner,de GER,"FW,MF",RB Leipzig,27-296,1996,2.3,2,1,0,1,1,0,0,,0,1,0,1,1,3,0,0,Matches
Silvan Widmer,ch SUI,DF,Mainz 05,30-297,1993,3.9,10,7,7,2,1,8,12,66.7,4,3,0,3,5,15,9,0,Matches
Patrick Wimmer,at AUT,FW,Wolfsburg,22-211,2001,3.1,7,3,5,2,0,6,7,85.7,1,8,0,8,2,9,3,0,Matches
Jonas Wind,dk DEN,FW,Wolfsburg,24-323,1999,15.6,5,3,2,1,2,3,8,37.5,5,8,3,5,1,6,13,0,Matches
Florian Wirtz,de GER,MF,Leverkusen,20-238,2003,14.0,10,7,5,3,2,4,13,30.8,9,13,1,12,5,15,2,0,Matches
Maximilian Wittek,de GER,"DF,MF",Bochum,28-128,1995,5.5,11,8,4,7,0,7,12,58.3,5,5,0,5,7,18,11,0,Matches
Maximilian Wöber,at AUT,DF,M'Gladbach,25-326,1998,14.7,34,17,21,12,1,13,23,56.5,10,31,18,13,28,62,74,0,Matches
Marius Wolf,de GER,DF,Dortmund,28-214,1995,7.0,12,7,4,7,1,6,13,46.2,7,4,0,4,4,16,8,0,Matches
Nick Woltemade,de GER,"FW,MF",Werder Bremen,21-316,2002,2.9,7,6,1,5,1,5,6,83.3,1,0,0,0,0,7,6,0,Matches
Jeong Woo-yeong,kr KOR,MF,Stuttgart,24-098,1999,4.2,6,4,2,4,0,3,5,60.0,2,3,0,3,5,11,1,0,Matches
Granit Xhaka,ch SUI,MF,Leverkusen,31-091,1992,15.7,18,12,6,11,1,7,17,41.2,10,20,5,15,10,28,22,0,Matches
Dan-Axel Zagadou,fr FRA,DF,Stuttgart,24-207,1999,13.1,15,9,12,3,0,3,7,42.9,4,23,18,5,20,35,62,1,Matches
Robin Zentner,de GER,GK,Mainz 05,29-060,1994,12.0,0,0,0,0,0,0,2,0.0,2,0,0,0,0,0,5,0,Matches
Cedric Zesiger,ch SUI,DF,Wolfsburg,25-186,1998,10.4,7,2,5,2,0,6,11,54.5,5,20,11,9,9,16,46,1,Matches
Michael Zetterer,de GER,GK,Werder Bremen,28-168,1995,9.0,1,0,1,0,0,1,1,100.0,0,0,0,0,0,1,3,2,Matches
Christoph Zimmermann,de GER,DF,Darmstadt 98,30-349,1993,4.9,13,11,9,4,0,9,15,60.0,6,10,8,2,10,23,21,1,Matches
Simon Zoller,de GER,"FW,MF",Bochum,32-184,1991,0.5,0,0,0,0,0,0,0,,0,1,0,1,0,0,0,0,Matches
